laus_code,state_fips_code,county_fips_code,name,year,labor_force,employed,unemployed,unemployment_rate
CN0100100000000,01,001,"Autauga County, AL",2014,25429,23933,1496,5.900000
CN0100300000000,01,003,"Baldwin County, AL",2014,85815,80620,5195,6.100000
CN0100500000000,01,005,"Barbour County, AL",2014,8798,7847,951,10.800000
CN0100700000000,01,007,"Bibb County, AL",2014,8560,7949,611,7.100000
CN0100900000000,01,009,"Blount County, AL",2014,24614,23101,1513,6.100000
CN0101100000000,01,011,"Bullock County, AL",2014,4679,4254,425,9.100000
CN0101300000000,01,013,"Butler County, AL",2014,9253,8460,793,8.600000
CN0101500000000,01,015,"Calhoun County, AL",2014,46924,43208,3716,7.900000
CN0101700000000,01,017,"Chambers County, AL",2014,15190,14165,1025,6.700000
CN0101900000000,01,019,"Cherokee County, AL",2014,11299,10638,661,5.900000
CN0102100000000,01,021,"Chilton County, AL",2014,19121,17920,1201,6.300000
CN0102300000000,01,023,"Choctaw County, AL",2014,4479,4073,406,9.100000
CN0102500000000,01,025,"Clarke County, AL",2014,8101,7091,1010,12.500000
CN0102700000000,01,027,"Clay County, AL",2014,5446,5053,393,7.200000
CN0102900000000,01,029,"Cleburne County, AL",2014,5764,5377,387,6.700000
CN0103100000000,01,031,"Coffee County, AL",2014,20213,18862,1351,6.700000
CN0103300000000,01,033,"Colbert County, AL",2014,24016,22045,1971,8.200000
CN0103500000000,01,035,"Conecuh County, AL",2014,4629,4132,497,10.700000
CN0103700000000,01,037,"Coosa County, AL",2014,4400,4011,389,8.800000
CN0103900000000,01,039,"Covington County, AL",2014,15771,14547,1224,7.800000
CN0104100000000,01,041,"Crenshaw County, AL",2014,6244,5810,434,7.000000
CN0104300000000,01,043,"Cullman County, AL",2014,35477,33314,2163,6.100000
CN0104500000000,01,045,"Dale County, AL",2014,20397,18938,1459,7.200000
CN0104700000000,01,047,"Dallas County, AL",2014,15747,13926,1821,11.600000
CN0104900000000,01,049,"DeKalb County, AL",2014,28655,26666,1989,6.900000
CN0105100000000,01,051,"Elmore County, AL",2014,36381,34281,2100,5.800000
CN0105300000000,01,053,"Escambia County, AL",2014,14194,13027,1167,8.200000
CN0105500000000,01,055,"Etowah County, AL",2014,43578,40515,3063,7.000000
CN0105700000000,01,057,"Fayette County, AL",2014,6281,5785,496,7.900000
CN0105900000000,01,059,"Franklin County, AL",2014,13641,12578,1063,7.800000
CN0106100000000,01,061,"Geneva County, AL",2014,10783,10056,727,6.700000
CN0106300000000,01,063,"Greene County, AL",2014,3000,2621,379,12.600000
CN0106500000000,01,065,"Hale County, AL",2014,6142,5540,602,9.800000
CN0106700000000,01,067,"Henry County, AL",2014,6799,6293,506,7.400000
CN0106900000000,01,069,"Houston County, AL",2014,44834,41781,3053,6.800000
CN0107100000000,01,071,"Jackson County, AL",2014,23306,21626,1680,7.200000
CN0107300000000,01,073,"Jefferson County, AL",2014,311833,292161,19672,6.300000
CN0107500000000,01,075,"Lamar County, AL",2014,5547,5151,396,7.100000
CN0107700000000,01,077,"Lauderdale County, AL",2014,43367,40253,3114,7.200000
CN0107900000000,01,079,"Lawrence County, AL",2014,13988,12835,1153,8.200000
CN0108100000000,01,081,"Lee County, AL",2014,70960,66991,3969,5.600000
CN0108300000000,01,083,"Limestone County, AL",2014,39016,36635,2381,6.100000
CN0108500000000,01,085,"Lowndes County, AL",2014,3906,3402,504,12.900000
CN0108700000000,01,087,"Macon County, AL",2014,8211,7461,750,9.100000
CN0108900000000,01,089,"Madison County, AL",2014,169656,159203,10453,6.200000
CN0109100000000,01,091,"Marengo County, AL",2014,7597,6986,611,8.000000
CN0109300000000,01,093,"Marion County, AL",2014,12160,11181,979,8.100000
CN0109500000000,01,095,"Marshall County, AL",2014,39588,36936,2652,6.700000
CN0109700000000,01,097,"Mobile County, AL",2014,184133,169947,14186,7.700000
CN0109900000000,01,099,"Monroe County, AL",2014,7530,6679,851,11.300000
CN0110100000000,01,101,"Montgomery County, AL",2014,104838,97592,7246,6.900000
CN0110300000000,01,103,"Morgan County, AL",2014,55799,52105,3694,6.600000
CN0110500000000,01,105,"Perry County, AL",2014,3454,3024,430,12.400000
CN0110700000000,01,107,"Pickens County, AL",2014,7429,6818,611,8.200000
CN0110900000000,01,109,"Pike County, AL",2014,14839,13757,1082,7.300000
CN0111100000000,01,111,"Randolph County, AL",2014,9166,8537,629,6.900000
CN0111300000000,01,113,"Russell County, AL",2014,24634,23001,1633,6.600000
CN0111500000000,01,115,"St. Clair County, AL",2014,38380,36153,2227,5.800000
CN0111700000000,01,117,"Shelby County, AL",2014,106051,101254,4797,4.500000
CN0111900000000,01,119,"Sumter County, AL",2014,5321,4850,471,8.900000
CN0112100000000,01,121,"Talladega County, AL",2014,34916,32234,2682,7.700000
CN0112300000000,01,123,"Tallapoosa County, AL",2014,18136,16748,1388,7.700000
CN0112500000000,01,125,"Tuscaloosa County, AL",2014,96911,91140,5771,6.000000
CN0112700000000,01,127,"Walker County, AL",2014,25912,23924,1988,7.700000
CN0112900000000,01,129,"Washington County, AL",2014,6556,5908,648,9.900000
CN0113100000000,01,131,"Wilcox County, AL",2014,2849,2354,495,17.400000
CN0113300000000,01,133,"Winston County, AL",2014,9485,8653,832,8.800000
CN0201300000000,02,013,"Aleutians East Borough, AK",2014,2246,2143,103,4.600000
CN0201600000000,02,016,"Aleutians West Census Area, AK",2014,4419,4201,218,4.900000
CN0202000000000,02,020,"Anchorage Borough/municipality, AK",2014,159955,151731,8224,5.100000
CN0205000000000,02,050,"Bethel Census Area, AK",2014,7325,6154,1171,16.000000
CN0206000000000,02,060,"Bristol Bay Borough, AK",2014,499,459,40,8.000000
CN0206800000000,02,068,"Denali Borough, AK",2014,1070,962,108,10.100000
CN0207000000000,02,070,"Dillingham Census Area, AK",2014,2144,1931,213,9.900000
CN0209000000000,02,090,"Fairbanks North Star Borough, AK",2014,47119,44411,2708,5.700000
CN0210000000000,02,100,"Haines Borough, AK",2014,1109,993,116,10.500000
CN0210500000000,02,105,"Hoonah-Angoon Census Area, AK",2014,1141,969,172,15.100000
CN0211000000000,02,110,"Juneau Borough/city, AK",2014,17457,16574,883,5.100000
CN0212200000000,02,122,"Kenai Peninsula Borough, AK",2014,27969,25789,2180,7.800000
CN0213000000000,02,130,"Ketchikan Gateway Borough, AK",2014,7108,6568,540,7.600000
CN0215000000000,02,150,"Kodiak Island Borough, AK",2014,6617,6243,374,5.700000
CN0216400000000,02,164,"Lake and Peninsula Borough, AK",2014,637,539,98,15.400000
CN0217000000000,02,170,"Matanuska-Susitna Borough, AK",2014,44183,40645,3538,8.000000
CN0218000000000,02,180,"Nome Census Area, AK",2014,4190,3682,508,12.100000
CN0218500000000,02,185,"North Slope Borough, AK",2014,4326,4075,251,5.800000
CN0218800000000,02,188,"Northwest Arctic Borough, AK",2014,3061,2551,510,16.700000
CN0219500000000,02,195,"Petersburg Census Area, AK",2014,1636,1475,161,9.800000
CN0219800000000,02,198,"Prince of Wales-Hyder Census Area, AK",2014,2799,2427,372,13.300000
CN0222000000000,02,220,"Sitka Borough/city, AK",2014,4701,4461,240,5.100000
CN0223000000000,02,230,"Skagway Municipality, AK",2014,805,710,95,11.800000
CN0224000000000,02,240,"Southeast Fairbanks Census Area, AK",2014,2946,2562,384,13.000000
CN0226100000000,02,261,"Valdez-Cordova Census Area, AK",2014,4907,4439,468,9.500000
CN0227000000000,02,270,"Wade Hampton Census Area, AK",2014,2835,2164,671,23.700000
CN0227500000000,02,275,"Wrangell Borough/city, AK",2014,1063,971,92,8.700000
CN0228200000000,02,282,"Yakutat Borough/city, AK",2014,277,250,27,9.700000
CN0229000000000,02,290,"Yukon-Koyukuk Census Area, AK",2014,2620,2130,490,18.700000
CN0400100000000,04,001,"Apache County, AZ",2014,21185,17802,3383,16.000000
CN0400300000000,04,003,"Cochise County, AZ",2014,50978,46677,4301,8.400000
CN0400500000000,04,005,"Coconino County, AZ",2014,71901,66755,5146,7.200000
CN0400700000000,04,007,"Gila County, AZ",2014,21363,19566,1797,8.400000
CN0400900000000,04,009,"Graham County, AZ",2014,14418,13316,1102,7.600000
CN0401100000000,04,011,"Greenlee County, AZ",2014,4699,4393,306,6.500000
CN0401200000000,04,012,"La Paz County, AZ",2014,8011,7374,637,8.000000
CN0401300000000,04,013,"Maricopa County, AZ",2014,1956284,1841365,114919,5.900000
CN0401500000000,04,015,"Mohave County, AZ",2014,78247,71342,6905,8.800000
CN0401700000000,04,017,"Navajo County, AZ",2014,41593,36908,4685,11.300000
CN0401900000000,04,019,"Pima County, AZ",2014,461806,433321,28485,6.200000
CN0402100000000,04,021,"Pinal County, AZ",2014,151645,140679,10966,7.200000
CN0402300000000,04,023,"Santa Cruz County, AZ",2014,20258,17593,2665,13.200000
CN0402500000000,04,025,"Yavapai County, AZ",2014,95402,89353,6049,6.300000
CN0402700000000,04,027,"Yuma County, AZ",2014,92838,71198,21640,23.300000
CN0500100000000,05,001,"Arkansas County, AR",2014,9291,8787,504,5.400000
CN0500300000000,05,003,"Ashley County, AR",2014,8470,7675,795,9.400000
CN0500500000000,05,005,"Baxter County, AR",2014,15740,14671,1069,6.800000
CN0500700000000,05,007,"Benton County, AR",2014,113328,108068,5260,4.600000
CN0500900000000,05,009,"Boone County, AR",2014,15417,14469,948,6.100000
CN0501100000000,05,011,"Bradley County, AR",2014,4123,3773,350,8.500000
CN0501300000000,05,013,"Calhoun County, AR",2014,2353,2194,159,6.800000
CN0501500000000,05,015,"Carroll County, AR",2014,12379,11728,651,5.300000
CN0501700000000,05,017,"Chicot County, AR",2014,3837,3430,407,10.600000
CN0501900000000,05,019,"Clark County, AR",2014,9443,8779,664,7.000000
CN0502100000000,05,021,"Clay County, AR",2014,6334,5824,510,8.100000
CN0502300000000,05,023,"Cleburne County, AR",2014,9607,8807,800,8.300000
CN0502500000000,05,025,"Cleveland County, AR",2014,3437,3198,239,7.000000
CN0502700000000,05,027,"Columbia County, AR",2014,9369,8685,684,7.300000
CN0502900000000,05,029,"Conway County, AR",2014,8466,7868,598,7.100000
CN0503100000000,05,031,"Craighead County, AR",2014,49142,46441,2701,5.500000
CN0503300000000,05,033,"Crawford County, AR",2014,26433,24823,1610,6.100000
CN0503500000000,05,035,"Crittenden County, AR",2014,21184,19642,1542,7.300000
CN0503700000000,05,037,"Cross County, AR",2014,8002,7475,527,6.600000
CN0503900000000,05,039,"Dallas County, AR",2014,2861,2590,271,9.500000
CN0504100000000,05,041,"Desha County, AR",2014,5515,5058,457,8.300000
CN0504300000000,05,043,"Drew County, AR",2014,7895,7213,682,8.600000
CN0504500000000,05,045,"Faulkner County, AR",2014,58134,54835,3299,5.700000
CN0504700000000,05,047,"Franklin County, AR",2014,7213,6796,417,5.800000
CN0504900000000,05,049,"Fulton County, AR",2014,4710,4428,282,6.000000
CN0505100000000,05,051,"Garland County, AR",2014,40044,37480,2564,6.400000
CN0505300000000,05,053,"Grant County, AR",2014,8116,7665,451,5.600000
CN0505500000000,05,055,"Greene County, AR",2014,19403,18142,1261,6.500000
CN0505700000000,05,057,"Hempstead County, AR",2014,9812,9212,600,6.100000
CN0505900000000,05,059,"Hot Spring County, AR",2014,13863,13049,814,5.900000
CN0506100000000,05,061,"Howard County, AR",2014,6249,5883,366,5.900000
CN0506300000000,05,063,"Independence County, AR",2014,15271,14055,1216,8.000000
CN0506500000000,05,065,"Izard County, AR",2014,4841,4472,369,7.600000
CN0506700000000,05,067,"Jackson County, AR",2014,6115,5543,572,9.400000
CN0506900000000,05,069,"Jefferson County, AR",2014,29195,26592,2603,8.900000
CN0507100000000,05,071,"Johnson County, AR",2014,10185,9510,675,6.600000
CN0507300000000,05,073,"Lafayette County, AR",2014,2641,2430,211,8.000000
CN0507500000000,05,075,"Lawrence County, AR",2014,6994,6476,518,7.400000
CN0507700000000,05,077,"Lee County, AR",2014,3226,2972,254,7.900000
CN0507900000000,05,079,"Lincoln County, AR",2014,4144,3841,303,7.300000
CN0508100000000,05,081,"Little River County, AR",2014,5534,5166,368,6.600000
CN0508300000000,05,083,"Logan County, AR",2014,9003,8455,548,6.100000
CN0508500000000,05,085,"Lonoke County, AR",2014,32178,30506,1672,5.200000
CN0508700000000,05,087,"Madison County, AR",2014,6954,6614,340,4.900000
CN0508900000000,05,089,"Marion County, AR",2014,6436,6020,416,6.500000
CN0509100000000,05,091,"Miller County, AR",2014,19052,17905,1147,6.000000
CN0509300000000,05,093,"Mississippi County, AR",2014,18954,17190,1764,9.300000
CN0509500000000,05,095,"Monroe County, AR",2014,3080,2870,210,6.800000
CN0509700000000,05,097,"Montgomery County, AR",2014,3321,3052,269,8.100000
CN0509900000000,05,099,"Nevada County, AR",2014,3646,3423,223,6.100000
CN0510100000000,05,101,"Newton County, AR",2014,3361,3159,202,6.000000
CN0510300000000,05,103,"Ouachita County, AR",2014,9883,9087,796,8.100000
CN0510500000000,05,105,"Perry County, AR",2014,4240,3914,326,7.700000
CN0510700000000,05,107,"Phillips County, AR",2014,7199,6508,691,9.600000
CN0510900000000,05,109,"Pike County, AR",2014,4160,3849,311,7.500000
CN0511100000000,05,111,"Poinsett County, AR",2014,10073,9376,697,6.900000
CN0511300000000,05,113,"Polk County, AR",2014,8362,7825,537,6.400000
CN0511500000000,05,115,"Pope County, AR",2014,29204,27346,1858,6.400000
CN0511700000000,05,117,"Prairie County, AR",2014,3767,3543,224,5.900000
CN0511900000000,05,119,"Pulaski County, AR",2014,182809,172578,10231,5.600000
CN0512100000000,05,121,"Randolph County, AR",2014,6479,5957,522,8.100000
CN0512300000000,05,123,"St. Francis County, AR",2014,8826,8039,787,8.900000
CN0512500000000,05,125,"Saline County, AR",2014,53685,51029,2656,4.900000
CN0512700000000,05,127,"Scott County, AR",2014,4531,4296,235,5.200000
CN0512900000000,05,129,"Searcy County, AR",2014,2954,2761,193,6.500000
CN0513100000000,05,131,"Sebastian County, AR",2014,56683,53419,3264,5.800000
CN0513300000000,05,133,"Sevier County, AR",2014,5722,5322,400,7.000000
CN0513500000000,05,135,"Sharp County, AR",2014,5874,5363,511,8.700000
CN0513700000000,05,137,"Stone County, AR",2014,4661,4290,371,8.000000
CN0513900000000,05,139,"Union County, AR",2014,16374,15137,1237,7.600000
CN0514100000000,05,141,"Van Buren County, AR",2014,6373,5852,521,8.200000
CN0514300000000,05,143,"Washington County, AR",2014,108276,103486,4790,4.400000
CN0514500000000,05,145,"White County, AR",2014,34055,31598,2457,7.200000
CN0514700000000,05,147,"Woodruff County, AR",2014,3150,2903,247,7.800000
CN0514900000000,05,149,"Yell County, AR",2014,8963,8457,506,5.600000
CN0600100000000,06,001,"Alameda County, CA",2014,811346,763663,47683,5.900000
CN0600300000000,06,003,"Alpine County, CA",2014,491,448,43,8.800000
CN0600500000000,06,005,"Amador County, CA",2014,14459,13252,1207,8.300000
CN0600700000000,06,007,"Butte County, CA",2014,101924,93104,8820,8.700000
CN0600900000000,06,009,"Calaveras County, CA",2014,20307,18666,1641,8.100000
CN0601100000000,06,011,"Colusa County, CA",2014,11152,9205,1947,17.500000
CN0601300000000,06,013,"Contra Costa County, CA",2014,544022,510513,33509,6.200000
CN0601500000000,06,015,"Del Norte County, CA",2014,10041,9019,1022,10.200000
CN0601700000000,06,017,"El Dorado County, CA",2014,88797,82585,6212,7.000000
CN0601900000000,06,019,"Fresno County, CA",2014,441022,389805,51217,11.600000
CN0602100000000,06,021,"Glenn County, CA",2014,12908,11533,1375,10.700000
CN0602300000000,06,023,"Humboldt County, CA",2014,62751,58495,4256,6.800000
CN0602500000000,06,025,"Imperial County, CA",2014,80266,61309,18957,23.600000
CN0602700000000,06,027,"Inyo County, CA",2014,9213,8570,643,7.000000
CN0602900000000,06,029,"Kern County, CA",2014,394849,353645,41204,10.400000
CN0603100000000,06,031,"Kings County, CA",2014,57393,50473,6920,12.100000
CN0603300000000,06,033,"Lake County, CA",2014,29928,27275,2653,8.900000
CN0603500000000,06,035,"Lassen County, CA",2014,10808,9806,1002,9.300000
CN0603700000000,06,037,"Los Angeles County, CA",2014,5025883,4610795,415088,8.300000
CN0603900000000,06,039,"Madera County, CA",2014,63184,56203,6981,11.000000
CN0604100000000,06,041,"Marin County, CA",2014,140051,134071,5980,4.300000
CN0604300000000,06,043,"Mariposa County, CA",2014,8128,7413,715,8.800000
CN0604500000000,06,045,"Mendocino County, CA",2014,41067,38229,2838,6.900000
CN0604700000000,06,047,"Merced County, CA",2014,115386,100615,14771,12.800000
CN0604900000000,06,049,"Modoc County, CA",2014,3365,3012,353,10.500000
CN0605100000000,06,051,"Mono County, CA",2014,8161,7572,589,7.200000
CN0605300000000,06,053,"Monterey County, CA",2014,219814,199894,19920,9.100000
CN0605500000000,06,055,"Napa County, CA",2014,74041,69912,4129,5.600000
CN0605700000000,06,057,"Nevada County, CA",2014,47906,44753,3153,6.600000
CN0605900000000,06,059,"Orange County, CA",2014,1575606,1489164,86442,5.500000
CN0606100000000,06,061,"Placer County, CA",2014,176474,165421,11053,6.300000
CN0606300000000,06,063,"Plumas County, CA",2014,8140,7188,952,11.700000
CN0606500000000,06,065,"Riverside County, CA",2014,1010706,927334,83372,8.200000
CN0606700000000,06,067,"Sacramento County, CA",2014,682174,632195,49979,7.300000
CN0606900000000,06,069,"San Benito County, CA",2014,29242,26511,2731,9.300000
CN0607100000000,06,071,"San Bernardino County, CA",2014,909188,835991,73197,8.100000
CN0607300000000,06,073,"San Diego County, CA",2014,1546363,1447147,99216,6.400000
CN0607500000000,06,075,"San Francisco County/city, CA",2014,532645,509338,23307,4.400000
CN0607700000000,06,077,"San Joaquin County, CA",2014,311061,277967,33094,10.600000
CN0607900000000,06,079,"San Luis Obispo County, CA",2014,139865,132027,7838,5.600000
CN0608100000000,06,081,"San Mateo County, CA",2014,430778,412661,18117,4.200000
CN0608300000000,06,083,"Santa Barbara County, CA",2014,218721,205421,13300,6.100000
CN0608500000000,06,085,"Santa Clara County, CA",2014,995256,943520,51736,5.200000
CN0608700000000,06,087,"Santa Cruz County, CA",2014,142626,130157,12469,8.700000
CN0608900000000,06,089,"Shasta County, CA",2014,75458,68165,7293,9.700000
CN0609100000000,06,091,"Sierra County, CA",2014,1448,1303,145,10.000000
CN0609300000000,06,093,"Siskiyou County, CA",2014,18001,15973,2028,11.300000
CN0609500000000,06,095,"Solano County, CA",2014,203706,188520,15186,7.500000
CN0609700000000,06,097,"Sonoma County, CA",2014,257295,242944,14351,5.600000
CN0609900000000,06,099,"Stanislaus County, CA",2014,241446,214361,27085,11.200000
CN0610100000000,06,101,"Sutter County, CA",2014,44455,38802,5653,12.700000
CN0610300000000,06,103,"Tehama County, CA",2014,25250,22807,2443,9.700000
CN0610500000000,06,105,"Trinity County, CA",2014,5045,4544,501,9.900000
CN0610700000000,06,107,"Tulare County, CA",2014,198631,172359,26272,13.200000
CN0610900000000,06,109,"Tuolumne County, CA",2014,21638,19750,1888,8.700000
CN0611100000000,06,111,"Ventura County, CA",2014,431547,402720,28827,6.700000
CN0611300000000,06,113,"Yolo County, CA",2014,101799,93985,7814,7.700000
CN0611500000000,06,115,"Yuba County, CA",2014,28165,25007,3158,11.200000
CN0800100000000,08,001,"Adams County, CO",2014,245361,231357,14004,5.700000
CN0800300000000,08,003,"Alamosa County, CO",2014,7558,7022,536,7.100000
CN0800500000000,08,005,"Arapahoe County, CO",2014,333429,317086,16343,4.900000
CN0800700000000,08,007,"Archuleta County, CO",2014,5751,5407,344,6.000000
CN0800900000000,08,009,"Baca County, CO",2014,1962,1907,55,2.800000
CN0801100000000,08,011,"Bent County, CO",2014,1673,1585,88,5.300000
CN0801300000000,08,013,"Boulder County, CO",2014,177744,170468,7276,4.100000
CN0801400000000,08,014,"Broomfield County/city, CO",2014,33583,32147,1436,4.300000
CN0801500000000,08,015,"Chaffee County, CO",2014,8501,8125,376,4.400000
CN0801700000000,08,017,"Cheyenne County, CO",2014,998,969,29,2.900000
CN0801900000000,08,019,"Clear Creek County, CO",2014,5564,5305,259,4.700000
CN0802100000000,08,021,"Conejos County, CO",2014,3629,3345,284,7.800000
CN0802300000000,08,023,"Costilla County, CO",2014,1622,1474,148,9.100000
CN0802500000000,08,025,"Crowley County, CO",2014,1313,1233,80,6.100000
CN0802700000000,08,027,"Custer County, CO",2014,1994,1901,93,4.700000
CN0802900000000,08,029,"Delta County, CO",2014,13743,12794,949,6.900000
CN0803100000000,08,031,"Denver County/city, CO",2014,370487,352427,18060,4.900000
CN0803300000000,08,033,"Dolores County, CO",2014,1285,1233,52,4.000000
CN0803500000000,08,035,"Douglas County, CO",2014,168842,162063,6779,4.000000
CN0803700000000,08,037,"Eagle County, CO",2014,32739,31357,1382,4.200000
CN0803900000000,08,039,"Elbert County, CO",2014,13036,12480,556,4.300000
CN0804100000000,08,041,"El Paso County, CO",2014,308020,289415,18605,6.000000
CN0804300000000,08,043,"Fremont County, CO",2014,14641,13449,1192,8.100000
CN0804500000000,08,045,"Garfield County, CO",2014,31505,29871,1634,5.200000
CN0804700000000,08,047,"Gilpin County, CO",2014,3387,3239,148,4.400000
CN0804900000000,08,049,"Grand County, CO",2014,8934,8571,363,4.100000
CN0805100000000,08,051,"Gunnison County, CO",2014,9721,9325,396,4.100000
CN0805300000000,08,053,"Hinsdale County, CO",2014,444,427,17,3.800000
CN0805500000000,08,055,"Huerfano County, CO",2014,2437,2192,245,10.100000
CN0805700000000,08,057,"Jackson County, CO",2014,848,818,30,3.500000
CN0805900000000,08,059,"Jefferson County, CO",2014,311855,297657,14198,4.600000
CN0806100000000,08,061,"Kiowa County, CO",2014,763,737,26,3.400000
CN0806300000000,08,063,"Kit Carson County, CO",2014,4373,4239,134,3.100000
CN0806500000000,08,065,"Lake County, CO",2014,4569,4349,220,4.800000
CN0806700000000,08,067,"La Plata County, CO",2014,30136,28861,1275,4.200000
CN0806900000000,08,069,"Larimer County, CO",2014,177264,169686,7578,4.300000
CN0807100000000,08,071,"Las Animas County, CO",2014,6522,6024,498,7.600000
CN0807300000000,08,073,"Lincoln County, CO",2014,2144,2057,87,4.100000
CN0807500000000,08,075,"Logan County, CO",2014,11088,10667,421,3.800000
CN0807700000000,08,077,"Mesa County, CO",2014,73608,69068,4540,6.200000
CN0807900000000,08,079,"Mineral County, CO",2014,427,405,22,5.200000
CN0808100000000,08,081,"Moffat County, CO",2014,7353,6931,422,5.700000
CN0808300000000,08,083,"Montezuma County, CO",2014,12711,11934,777,6.100000
CN0808500000000,08,085,"Montrose County, CO",2014,19393,18068,1325,6.800000
CN0808700000000,08,087,"Morgan County, CO",2014,15010,14319,691,4.600000
CN0808900000000,08,089,"Otero County, CO",2014,8097,7482,615,7.600000
CN0809100000000,08,091,"Ouray County, CO",2014,2135,2018,117,5.500000
CN0809300000000,08,093,"Park County, CO",2014,9469,9030,439,4.600000
CN0809500000000,08,095,"Phillips County, CO",2014,2260,2185,75,3.300000
CN0809700000000,08,097,"Pitkin County, CO",2014,11030,10491,539,4.900000
CN0809900000000,08,099,"Prowers County, CO",2014,5783,5507,276,4.800000
CN0810100000000,08,101,"Pueblo County, CO",2014,73037,67679,5358,7.300000
CN0810300000000,08,103,"Rio Blanco County, CO",2014,2954,2782,172,5.800000
CN0810500000000,08,105,"Rio Grande County, CO",2014,4862,4423,439,9.000000
CN0810700000000,08,107,"Routt County, CO",2014,14458,13852,606,4.200000
CN0810900000000,08,109,"Saguache County, CO",2014,3022,2761,261,8.600000
CN0811100000000,08,111,"San Juan County, CO",2014,473,448,25,5.300000
CN0811300000000,08,113,"San Miguel County, CO",2014,4922,4689,233,4.700000
CN0811500000000,08,115,"Sedgwick County, CO",2014,1091,1041,50,4.600000
CN0811700000000,08,117,"Summit County, CO",2014,20263,19580,683,3.400000
CN0811900000000,08,119,"Teller County, CO",2014,11724,11038,686,5.900000
CN0812100000000,08,121,"Washington County, CO",2014,2679,2593,86,3.200000
CN0812300000000,08,123,"Weld County, CO",2014,146103,139519,6584,4.500000
CN0812500000000,08,125,"Yuma County, CO",2014,5007,4840,167,3.300000
CN0900100000000,09,001,"Fairfield County, CT",2014,475888,446528,29360,6.200000
CN0900300000000,09,003,"Hartford County, CT",2014,471431,439054,32377,6.900000
CN0900500000000,09,005,"Litchfield County, CT",2014,105945,99650,6295,5.900000
CN0900700000000,09,007,"Middlesex County, CT",2014,92018,86839,5179,5.600000
CN0900900000000,09,009,"New Haven County, CT",2014,455537,422625,32912,7.200000
CN0901100000000,09,011,"New London County, CT",2014,137254,128000,9254,6.700000
CN0901300000000,09,013,"Tolland County, CT",2014,84100,79365,4735,5.600000
CN0901500000000,09,015,"Windham County, CT",2014,62958,58361,4597,7.300000
CN1000100000000,10,001,"Kent County, DE",2014,75239,70459,4780,6.400000
CN1000300000000,10,003,"New Castle County, DE",2014,282787,267094,15693,5.500000
CN1000500000000,10,005,"Sussex County, DE",2014,93742,88360,5382,5.700000
CN1100100000000,11,001,District of Columbia,2014,377448,348049,29399,7.800000
CN1200100000000,12,001,"Alachua County, FL",2014,130895,124110,6785,5.200000
CN1200300000000,12,003,"Baker County, FL",2014,11385,10673,712,6.300000
CN1200500000000,12,005,"Bay County, FL",2014,87777,82282,5495,6.300000
CN1200700000000,12,007,"Bradford County, FL",2014,10884,10279,605,5.600000
CN1200900000000,12,009,"Brevard County, FL",2014,260004,242013,17991,6.900000
CN1201100000000,12,011,"Broward County, FL",2014,994081,936010,58071,5.800000
CN1201300000000,12,013,"Calhoun County, FL",2014,4943,4603,340,6.900000
CN1201500000000,12,015,"Charlotte County, FL",2014,67003,62493,4510,6.700000
CN1201700000000,12,017,"Citrus County, FL",2014,48578,44470,4108,8.500000
CN1201900000000,12,019,"Clay County, FL",2014,98450,92823,5627,5.700000
CN1202100000000,12,021,"Collier County, FL",2014,161233,151727,9506,5.900000
CN1202300000000,12,023,"Columbia County, FL",2014,28619,26764,1855,6.500000
CN1202700000000,12,027,"DeSoto County, FL",2014,13011,12087,924,7.100000
CN1202900000000,12,029,"Dixie County, FL",2014,5621,5202,419,7.500000
CN1203100000000,12,031,"Duval County, FL",2014,463985,432916,31069,6.700000
CN1203300000000,12,033,"Escambia County, FL",2014,141015,132067,8948,6.300000
CN1203500000000,12,035,"Flagler County, FL",2014,43115,39887,3228,7.500000
CN1203700000000,12,037,"Franklin County, FL",2014,5038,4761,277,5.500000
CN1203900000000,12,039,"Gadsden County, FL",2014,19039,17517,1522,8.000000
CN1204100000000,12,041,"Gilchrist County, FL",2014,6707,6268,439,6.500000
CN1204300000000,12,043,"Glades County, FL",2014,5303,4922,381,7.200000
CN1204500000000,12,045,"Gulf County, FL",2014,6309,5930,379,6.000000
CN1204700000000,12,047,"Hamilton County, FL",2014,4612,4250,362,7.800000
CN1204900000000,12,049,"Hardee County, FL",2014,10377,9577,800,7.700000
CN1205100000000,12,051,"Hendry County, FL",2014,16851,15069,1782,10.600000
CN1205300000000,12,053,"Hernando County, FL",2014,67159,61880,5279,7.900000
CN1205500000000,12,055,"Highlands County, FL",2014,36531,33547,2984,8.200000
CN1205700000000,12,057,"Hillsborough County, FL",2014,684400,644436,39964,5.800000
CN1205900000000,12,059,"Holmes County, FL",2014,6960,6485,475,6.800000
CN1206100000000,12,061,"Indian River County, FL",2014,62028,57176,4852,7.800000
CN1206300000000,12,063,"Jackson County, FL",2014,17948,16801,1147,6.400000
CN1206500000000,12,065,"Jefferson County, FL",2014,5535,5177,358,6.500000
CN1206700000000,12,067,"Lafayette County, FL",2014,3396,3219,177,5.200000
CN1206900000000,12,069,"Lake County, FL",2014,139296,130439,8857,6.400000
CN1207100000000,12,071,"Lee County, FL",2014,311695,293078,18617,6.000000
CN1207300000000,12,073,"Leon County, FL",2014,150980,142641,8339,5.500000
CN1207500000000,12,075,"Levy County, FL",2014,16410,15279,1131,6.900000
CN1207700000000,12,077,"Liberty County, FL",2014,2802,2621,181,6.500000
CN1207900000000,12,079,"Madison County, FL",2014,7768,7193,575,7.400000
CN1208100000000,12,081,"Manatee County, FL",2014,160590,151377,9213,5.700000
CN1208300000000,12,083,"Marion County, FL",2014,132815,123146,9669,7.300000
CN1208500000000,12,085,"Martin County, FL",2014,69303,65061,4242,6.100000
CN1208600000000,12,086,"Miami-Dade County, FL",2014,1320447,1230641,89806,6.800000
CN1208700000000,12,087,"Monroe County, FL",2014,45263,43386,1877,4.100000
CN1208900000000,12,089,"Nassau County, FL",2014,36634,34499,2135,5.800000
CN1209100000000,12,091,"Okaloosa County, FL",2014,93119,88346,4773,5.100000
CN1209300000000,12,093,"Okeechobee County, FL",2014,18062,16750,1312,7.300000
CN1209500000000,12,095,"Orange County, FL",2014,681733,642229,39504,5.800000
CN1209700000000,12,097,"Osceola County, FL",2014,151665,141532,10133,6.700000
CN1209900000000,12,099,"Palm Beach County, FL",2014,688244,647646,40598,5.900000
CN1210100000000,12,101,"Pasco County, FL",2014,213279,198975,14304,6.700000
CN1210300000000,12,103,"Pinellas County, FL",2014,477751,449984,27767,5.800000
CN1210500000000,12,105,"Polk County, FL",2014,281330,261348,19982,7.100000
CN1210700000000,12,107,"Putnam County, FL",2014,28321,25857,2464,8.700000
CN1210900000000,12,109,"St. Johns County, FL",2014,109004,103866,5138,4.700000
CN1211100000000,12,111,"St. Lucie County, FL",2014,131012,120555,10457,8.000000
CN1211300000000,12,113,"Santa Rosa County, FL",2014,74167,70134,4033,5.400000
CN1211500000000,12,115,"Sarasota County, FL",2014,176427,166150,10277,5.800000
CN1211700000000,12,117,"Seminole County, FL",2014,239413,225966,13447,5.600000
CN1211900000000,12,119,"Sumter County, FL",2014,28306,26120,2186,7.700000
CN1212100000000,12,121,"Suwannee County, FL",2014,18251,17125,1126,6.200000
CN1212300000000,12,123,"Taylor County, FL",2014,9394,8732,662,7.000000
CN1212500000000,12,125,"Union County, FL",2014,4730,4444,286,6.000000
CN1212700000000,12,127,"Volusia County, FL",2014,239225,223228,15997,6.700000
CN1212900000000,12,129,"Wakulla County, FL",2014,14266,13522,744,5.200000
CN1213100000000,12,131,"Walton County, FL",2014,27226,25795,1431,5.300000
CN1213300000000,12,133,"Washington County, FL",2014,9824,9161,663,6.700000
CN1300100000000,13,001,"Appling County, GA",2014,8679,7903,776,8.900000
CN1300300000000,13,003,"Atkinson County, GA",2014,3628,3347,281,7.700000
CN1300500000000,13,005,"Bacon County, GA",2014,4854,4516,338,7.000000
CN1300700000000,13,007,"Baker County, GA",2014,1139,1038,101,8.900000
CN1300900000000,13,009,"Baldwin County, GA",2014,18366,16730,1636,8.900000
CN1301100000000,13,011,"Banks County, GA",2014,8100,7562,538,6.600000
CN1301300000000,13,013,"Barrow County, GA",2014,34873,32667,2206,6.300000
CN1301500000000,13,015,"Bartow County, GA",2014,47108,43736,3372,7.200000
CN1301700000000,13,017,"Ben Hill County, GA",2014,5624,5045,579,10.300000
CN1301900000000,13,019,"Berrien County, GA",2014,7160,6515,645,9.000000
CN1302100000000,13,021,"Bibb County, GA",2014,69480,63881,5599,8.100000
CN1302300000000,13,023,"Bleckley County, GA",2014,4599,4073,526,11.400000
CN1302500000000,13,025,"Brantley County, GA",2014,6938,6297,641,9.200000
CN1302700000000,13,027,"Brooks County, GA",2014,6754,6255,499,7.400000
CN1302900000000,13,029,"Bryan County, GA",2014,15480,14475,1005,6.500000
CN1303100000000,13,031,"Bulloch County, GA",2014,34379,31820,2559,7.400000
CN1303300000000,13,033,"Burke County, GA",2014,9363,8414,949,10.100000
CN1303500000000,13,035,"Butts County, GA",2014,10187,9414,773,7.600000
CN1303700000000,13,037,"Calhoun County, GA",2014,2142,1983,159,7.400000
CN1303900000000,13,039,"Camden County, GA",2014,21740,20255,1485,6.800000
CN1304300000000,13,043,"Candler County, GA",2014,5049,4685,364,7.200000
CN1304500000000,13,045,"Carroll County, GA",2014,51954,47698,4256,8.200000
CN1304700000000,13,047,"Catoosa County, GA",2014,31056,29124,1932,6.200000
CN1304900000000,13,049,"Charlton County, GA",2014,4841,4465,376,7.800000
CN1305100000000,13,051,"Chatham County, GA",2014,131738,122144,9594,7.300000
CN1305300000000,13,053,"Chattahoochee County, GA",2014,2417,2179,238,9.800000
CN1305500000000,13,055,"Chattooga County, GA",2014,10482,9658,824,7.900000
CN1305700000000,13,057,"Cherokee County, GA",2014,116873,110370,6503,5.600000
CN1305900000000,13,059,"Clarke County, GA",2014,57688,53703,3985,6.900000
CN1306100000000,13,061,"Clay County, GA",2014,916,815,101,11.000000
CN1306300000000,13,063,"Clayton County, GA",2014,125119,113422,11697,9.300000
CN1306500000000,13,065,"Clinch County, GA",2014,2791,2547,244,8.700000
CN1306700000000,13,067,"Cobb County, GA",2014,392464,368773,23691,6.000000
CN1306900000000,13,069,"Coffee County, GA",2014,17503,16018,1485,8.500000
CN1307100000000,13,071,"Colquitt County, GA",2014,20384,18704,1680,8.200000
CN1307300000000,13,073,"Columbia County, GA",2014,65341,61481,3860,5.900000
CN1307500000000,13,075,"Cook County, GA",2014,7404,6780,624,8.400000
CN1307700000000,13,077,"Coweta County, GA",2014,66404,62258,4146,6.200000
CN1307900000000,13,079,"Crawford County, GA",2014,5673,5248,425,7.500000
CN1308100000000,13,081,"Crisp County, GA",2014,9450,8580,870,9.200000
CN1308300000000,13,083,"Dade County, GA",2014,7998,7478,520,6.500000
CN1308500000000,13,085,"Dawson County, GA",2014,10832,10171,661,6.100000
CN1308700000000,13,087,"Decatur County, GA",2014,11415,10464,951,8.300000
CN1308900000000,13,089,"DeKalb County, GA",2014,370122,343108,27014,7.300000
CN1309100000000,13,091,"Dodge County, GA",2014,7537,6782,755,10.000000
CN1309300000000,13,093,"Dooly County, GA",2014,4655,4201,454,9.800000
CN1309500000000,13,095,"Dougherty County, GA",2014,38774,35144,3630,9.400000
CN1309700000000,13,097,"Douglas County, GA",2014,67568,62535,5033,7.400000
CN1309900000000,13,099,"Early County, GA",2014,4271,3886,385,9.000000
CN1310100000000,13,101,"Echols County, GA",2014,1826,1719,107,5.900000
CN1310300000000,13,103,"Effingham County, GA",2014,26275,24643,1632,6.200000
CN1310500000000,13,105,"Elbert County, GA",2014,8140,7429,711,8.700000
CN1310700000000,13,107,"Emanuel County, GA",2014,8557,7640,917,10.700000
CN1310900000000,13,109,"Evans County, GA",2014,4715,4406,309,6.600000
CN1311100000000,13,111,"Fannin County, GA",2014,9760,9003,757,7.800000
CN1311300000000,13,113,"Fayette County, GA",2014,53998,50652,3346,6.200000
CN1311500000000,13,115,"Floyd County, GA",2014,43404,39963,3441,7.900000
CN1311700000000,13,117,"Forsyth County, GA",2014,97533,92362,5171,5.300000
CN1311900000000,13,119,"Franklin County, GA",2014,9223,8459,764,8.300000
CN1312100000000,13,121,"Fulton County, GA",2014,511786,474995,36791,7.200000
CN1312300000000,13,123,"Gilmer County, GA",2014,11909,11029,880,7.400000
CN1312500000000,13,125,"Glascock County, GA",2014,1274,1167,107,8.400000
CN1312700000000,13,127,"Glynn County, GA",2014,37373,34545,2828,7.600000
CN1312900000000,13,129,"Gordon County, GA",2014,26047,24110,1937,7.400000
CN1313100000000,13,131,"Grady County, GA",2014,10420,9648,772,7.400000
CN1313300000000,13,133,"Greene County, GA",2014,6367,5839,528,8.300000
CN1313500000000,13,135,"Gwinnett County, GA",2014,442046,414891,27155,6.100000
CN1313700000000,13,137,"Habersham County, GA",2014,18876,17558,1318,7.000000
CN1313900000000,13,139,"Hall County, GA",2014,90087,84749,5338,5.900000
CN1314100000000,13,141,"Hancock County, GA",2014,2613,2301,312,11.900000
CN1314300000000,13,143,"Haralson County, GA",2014,11977,11043,934,7.800000
CN1314500000000,13,145,"Harris County, GA",2014,15615,14661,954,6.100000
CN1314700000000,13,147,"Hart County, GA",2014,10314,9513,801,7.800000
CN1314900000000,13,149,"Heard County, GA",2014,5023,4625,398,7.900000
CN1315100000000,13,151,"Henry County, GA",2014,103815,96265,7550,7.300000
CN1315300000000,13,153,"Houston County, GA",2014,66049,61502,4547,6.900000
CN1315500000000,13,155,"Irwin County, GA",2014,3162,2844,318,10.100000
CN1315700000000,13,157,"Jackson County, GA",2014,29658,27875,1783,6.000000
CN1315900000000,13,159,"Jasper County, GA",2014,6527,6094,433,6.600000
CN1316100000000,13,161,"Jeff Davis County, GA",2014,6409,5871,538,8.400000
CN1316300000000,13,163,"Jefferson County, GA",2014,6630,5864,766,11.600000
CN1316500000000,13,165,"Jenkins County, GA",2014,3289,2951,338,10.300000
CN1316700000000,13,167,"Johnson County, GA",2014,3930,3584,346,8.800000
CN1316900000000,13,169,"Jones County, GA",2014,13620,12745,875,6.400000
CN1317100000000,13,171,"Lamar County, GA",2014,7799,7056,743,9.500000
CN1317300000000,13,173,"Lanier County, GA",2014,3838,3536,302,7.900000
CN1317500000000,13,175,"Laurens County, GA",2014,18950,17147,1803,9.500000
CN1317700000000,13,177,"Lee County, GA",2014,14042,13149,893,6.400000
CN1317900000000,13,179,"Liberty County, GA",2014,25798,23772,2026,7.900000
CN1318100000000,13,181,"Lincoln County, GA",2014,3428,3142,286,8.300000
CN1318300000000,13,183,"Long County, GA",2014,6631,6146,485,7.300000
CN1318500000000,13,185,"Lowndes County, GA",2014,50839,47142,3697,7.300000
CN1318700000000,13,187,"Lumpkin County, GA",2014,15184,14187,997,6.600000
CN1318900000000,13,189,"McDuffie County, GA",2014,8963,8077,886,9.900000
CN1319100000000,13,191,"McIntosh County, GA",2014,5884,5403,481,8.200000
CN1319300000000,13,193,"Macon County, GA",2014,4618,4048,570,12.300000
CN1319500000000,13,195,"Madison County, GA",2014,12853,12022,831,6.500000
CN1319700000000,13,197,"Marion County, GA",2014,3390,3130,260,7.700000
CN1319900000000,13,199,"Meriwether County, GA",2014,8894,8023,871,9.800000
CN1320100000000,13,201,"Miller County, GA",2014,2667,2498,169,6.300000
CN1320500000000,13,205,"Mitchell County, GA",2014,8795,8095,700,8.000000
CN1320700000000,13,207,"Monroe County, GA",2014,12716,11863,853,6.700000
CN1320900000000,13,209,"Montgomery County, GA",2014,3920,3519,401,10.200000
CN1321100000000,13,211,"Morgan County, GA",2014,8400,7849,551,6.600000
CN1321300000000,13,213,"Murray County, GA",2014,15963,14447,1516,9.500000
CN1321500000000,13,215,"Muscogee County, GA",2014,81544,74579,6965,8.500000
CN1321700000000,13,217,"Newton County, GA",2014,48115,44157,3958,8.200000
CN1321900000000,13,219,"Oconee County, GA",2014,17130,16259,871,5.100000
CN1322100000000,13,221,"Oglethorpe County, GA",2014,6738,6306,432,6.400000
CN1322300000000,13,223,"Paulding County, GA",2014,75002,70342,4660,6.200000
CN1322500000000,13,225,"Peach County, GA",2014,11662,10543,1119,9.600000
CN1322700000000,13,227,"Pickens County, GA",2014,13842,12921,921,6.700000
CN1322900000000,13,229,"Pierce County, GA",2014,8038,7428,610,7.600000
CN1323100000000,13,231,"Pike County, GA",2014,8322,7740,582,7.000000
CN1323300000000,13,233,"Polk County, GA",2014,18328,16892,1436,7.800000
CN1323500000000,13,235,"Pulaski County, GA",2014,4134,3804,330,8.000000
CN1323700000000,13,237,"Putnam County, GA",2014,8094,7349,745,9.200000
CN1323900000000,13,239,"Quitman County, GA",2014,891,814,77,8.600000
CN1324100000000,13,241,"Rabun County, GA",2014,6568,6020,548,8.300000
CN1324300000000,13,243,"Randolph County, GA",2014,2702,2441,261,9.700000
CN1324500000000,13,245,"Richmond County, GA",2014,85777,78341,7436,8.700000
CN1324700000000,13,247,"Rockdale County, GA",2014,42296,38957,3339,7.900000
CN1324900000000,13,249,"Schley County, GA",2014,2148,1982,166,7.700000
CN1325100000000,13,251,"Screven County, GA",2014,5482,4932,550,10.000000
CN1325300000000,13,253,"Seminole County, GA",2014,3134,2835,299,9.500000
CN1325500000000,13,255,"Spalding County, GA",2014,27639,25014,2625,9.500000
CN1325700000000,13,257,"Stephens County, GA",2014,11258,10402,856,7.600000
CN1325900000000,13,259,"Stewart County, GA",2014,2194,2020,174,7.900000
CN1326100000000,13,261,"Sumter County, GA",2014,13517,12221,1296,9.600000
CN1326300000000,13,263,"Talbot County, GA",2014,2834,2610,224,7.900000
CN1326500000000,13,265,"Taliaferro County, GA",2014,598,532,66,11.000000
CN1326700000000,13,267,"Tattnall County, GA",2014,9584,8879,705,7.400000
CN1326900000000,13,269,"Taylor County, GA",2014,2879,2578,301,10.500000
CN1327100000000,13,271,"Telfair County, GA",2014,5158,4634,524,10.200000
CN1327300000000,13,273,"Terrell County, GA",2014,3567,3275,292,8.200000
CN1327500000000,13,275,"Thomas County, GA",2014,17312,15829,1483,8.600000
CN1327700000000,13,277,"Tift County, GA",2014,18119,16783,1336,7.400000
CN1327900000000,13,279,"Toombs County, GA",2014,12403,11174,1229,9.900000
CN1328100000000,13,281,"Towns County, GA",2014,4067,3704,363,8.900000
CN1328300000000,13,283,"Treutlen County, GA",2014,2779,2480,299,10.800000
CN1328500000000,13,285,"Troup County, GA",2014,36187,33488,2699,7.500000
CN1328700000000,13,287,"Turner County, GA",2014,3215,2960,255,7.900000
CN1328900000000,13,289,"Twiggs County, GA",2014,3066,2717,349,11.400000
CN1329100000000,13,291,"Union County, GA",2014,9413,8800,613,6.500000
CN1329300000000,13,293,"Upson County, GA",2014,11276,10240,1036,9.200000
CN1329500000000,13,295,"Walker County, GA",2014,29506,27392,2114,7.200000
CN1329700000000,13,297,"Walton County, GA",2014,41172,38507,2665,6.500000
CN1329900000000,13,299,"Ware County, GA",2014,14800,13595,1205,8.100000
CN1330100000000,13,301,"Warren County, GA",2014,2723,2453,270,9.900000
CN1330300000000,13,303,"Washington County, GA",2014,7520,6887,633,8.400000
CN1330500000000,13,305,"Wayne County, GA",2014,11828,10765,1063,9.000000
CN1330700000000,13,307,"Webster County, GA",2014,1017,931,86,8.500000
CN1330900000000,13,309,"Wheeler County, GA",2014,1899,1669,230,12.100000
CN1331100000000,13,311,"White County, GA",2014,13846,12972,874,6.300000
CN1331300000000,13,313,"Whitfield County, GA",2014,44869,41311,3558,7.900000
CN1331500000000,13,315,"Wilcox County, GA",2014,2865,2595,270,9.400000
CN1331700000000,13,317,"Wilkes County, GA",2014,3766,3412,354,9.400000
CN1331900000000,13,319,"Wilkinson County, GA",2014,3722,3396,326,8.800000
CN1332100000000,13,321,"Worth County, GA",2014,9050,8341,709,7.800000
CN1500100000000,15,001,"Hawaii County, HI",2014,87346,82500,4846,5.500000
CN1500300000000,15,003,"Honolulu County/city, HI",2014,463568,444678,18890,4.100000
CN1500700000000,15,007,"Kauai County, HI",2014,34623,32939,1684,4.900000
CN1500900000000,15,009,"Maui County, HI",2014,82639,78907,3732,4.500000
CN1600100000000,16,001,"Ada County, ID",2014,210284,201664,8620,4.100000
CN1600300000000,16,003,"Adams County, ID",2014,1662,1496,166,10.000000
CN1600500000000,16,005,"Bannock County, ID",2014,41703,39792,1911,4.600000
CN1600700000000,16,007,"Bear Lake County, ID",2014,2859,2732,127,4.400000
CN1600900000000,16,009,"Benewah County, ID",2014,3943,3622,321,8.100000
CN1601100000000,16,011,"Bingham County, ID",2014,22042,21040,1002,4.500000
CN1601300000000,16,013,"Blaine County, ID",2014,11429,10919,510,4.500000
CN1601500000000,16,015,"Boise County, ID",2014,2935,2759,176,6.000000
CN1601700000000,16,017,"Bonner County, ID",2014,18138,16858,1280,7.100000
CN1601900000000,16,019,"Bonneville County, ID",2014,49556,47468,2088,4.200000
CN1602100000000,16,021,"Boundary County, ID",2014,4880,4587,293,6.000000
CN1602300000000,16,023,"Butte County, ID",2014,1309,1241,68,5.200000
CN1602500000000,16,025,"Camas County, ID",2014,628,598,30,4.800000
CN1602700000000,16,027,"Canyon County, ID",2014,88595,83404,5191,5.900000
CN1602900000000,16,029,"Caribou County, ID",2014,3852,3689,163,4.200000
CN1603100000000,16,031,"Cassia County, ID",2014,11117,10640,477,4.300000
CN1603300000000,16,033,"Clark County, ID",2014,441,421,20,4.500000
CN1603500000000,16,035,"Clearwater County, ID",2014,3110,2817,293,9.400000
CN1603700000000,16,037,"Custer County, ID",2014,2120,1978,142,6.700000
CN1603900000000,16,039,"Elmore County, ID",2014,11011,10426,585,5.300000
CN1604100000000,16,041,"Franklin County, ID",2014,6386,6166,220,3.400000
CN1604300000000,16,043,"Fremont County, ID",2014,7013,6733,280,4.000000
CN1604500000000,16,045,"Gem County, ID",2014,7529,7088,441,5.900000
CN1604700000000,16,047,"Gooding County, ID",2014,7953,7634,319,4.000000
CN1604900000000,16,049,"Idaho County, ID",2014,6455,5969,486,7.500000
CN1605100000000,16,051,"Jefferson County, ID",2014,12275,11782,493,4.000000
CN1605300000000,16,053,"Jerome County, ID",2014,11077,10628,449,4.100000
CN1605500000000,16,055,"Kootenai County, ID",2014,70488,66506,3982,5.600000
CN1605700000000,16,057,"Latah County, ID",2014,19091,18303,788,4.100000
CN1605900000000,16,059,"Lemhi County, ID",2014,3358,3100,258,7.700000
CN1606100000000,16,061,"Lewis County, ID",2014,1606,1538,68,4.200000
CN1606300000000,16,063,"Lincoln County, ID",2014,2606,2457,149,5.700000
CN1606500000000,16,065,"Madison County, ID",2014,18851,18229,622,3.300000
CN1606700000000,16,067,"Minidoka County, ID",2014,10385,9909,476,4.600000
CN1606900000000,16,069,"Nez Perce County, ID",2014,20412,19583,829,4.100000
CN1607100000000,16,071,"Oneida County, ID",2014,2132,2048,84,3.900000
CN1607300000000,16,073,"Owyhee County, ID",2014,5086,4920,166,3.300000
CN1607500000000,16,075,"Payette County, ID",2014,10910,10302,608,5.600000
CN1607700000000,16,077,"Power County, ID",2014,3991,3798,193,4.800000
CN1607900000000,16,079,"Shoshone County, ID",2014,5215,4691,524,10.000000
CN1608100000000,16,081,"Teton County, ID",2014,5589,5369,220,3.900000
CN1608300000000,16,083,"Twin Falls County, ID",2014,38168,36513,1655,4.300000
CN1608500000000,16,085,"Valley County, ID",2014,4506,4169,337,7.500000
CN1608700000000,16,087,"Washington County, ID",2014,4544,4251,293,6.400000
CN1700100000000,17,001,"Adams County, IL",2014,32629,30872,1757,5.400000
CN1700300000000,17,003,"Alexander County, IL",2014,2617,2341,276,10.500000
CN1700500000000,17,005,"Bond County, IL",2014,7962,7444,518,6.500000
CN1700700000000,17,007,"Boone County, IL",2014,26253,24177,2076,7.900000
CN1700900000000,17,009,"Brown County, IL",2014,2747,2631,116,4.200000
CN1701100000000,17,011,"Bureau County, IL",2014,17539,16248,1291,7.400000
CN1701300000000,17,013,"Calhoun County, IL",2014,2411,2211,200,8.300000
CN1701500000000,17,015,"Carroll County, IL",2014,7888,7375,513,6.500000
CN1701700000000,17,017,"Cass County, IL",2014,6398,5955,443,6.900000
CN1701900000000,17,019,"Champaign County, IL",2014,103145,96902,6243,6.100000
CN1702100000000,17,021,"Christian County, IL",2014,15830,14624,1206,7.600000
CN1702300000000,17,023,"Clark County, IL",2014,7962,7384,578,7.300000
CN1702500000000,17,025,"Clay County, IL",2014,6441,5919,522,8.100000
CN1702700000000,17,027,"Clinton County, IL",2014,19958,18853,1105,5.500000
CN1702900000000,17,029,"Coles County, IL",2014,24362,22704,1658,6.800000
CN1703100000000,17,031,"Cook County, IL",2014,2666625,2470186,196439,7.400000
CN1703300000000,17,033,"Crawford County, IL",2014,9857,9203,654,6.600000
CN1703500000000,17,035,"Cumberland County, IL",2014,5883,5525,358,6.100000
CN1703700000000,17,037,"DeKalb County, IL",2014,54706,51114,3592,6.600000
CN1703900000000,17,039,"De Witt County, IL",2014,7977,7454,523,6.600000
CN1704100000000,17,041,"Douglas County, IL",2014,9853,9270,583,5.900000
CN1704300000000,17,043,"DuPage County, IL",2014,512869,483899,28970,5.600000
CN1704500000000,17,045,"Edgar County, IL",2014,9160,8502,658,7.200000
CN1704700000000,17,047,"Edwards County, IL",2014,2863,2668,195,6.800000
CN1704900000000,17,049,"Effingham County, IL",2014,18367,17345,1022,5.600000
CN1705100000000,17,051,"Fayette County, IL",2014,9745,8999,746,7.700000
CN1705300000000,17,053,"Ford County, IL",2014,6566,6165,401,6.100000
CN1705500000000,17,055,"Franklin County, IL",2014,16504,14960,1544,9.400000
CN1705700000000,17,057,"Fulton County, IL",2014,15762,14401,1361,8.600000
CN1705900000000,17,059,"Gallatin County, IL",2014,2410,2230,180,7.500000
CN1706100000000,17,061,"Greene County, IL",2014,6223,5792,431,6.900000
CN1706300000000,17,063,"Grundy County, IL",2014,25608,23428,2180,8.500000
CN1706500000000,17,065,"Hamilton County, IL",2014,4342,4085,257,5.900000
CN1706700000000,17,067,"Hancock County, IL",2014,8831,8239,592,6.700000
CN1706900000000,17,069,"Hardin County, IL",2014,1628,1485,143,8.800000
CN1707100000000,17,071,"Henderson County, IL",2014,3750,3513,237,6.300000
CN1707300000000,17,073,"Henry County, IL",2014,25336,23634,1702,6.700000
CN1707500000000,17,075,"Iroquois County, IL",2014,14801,13836,965,6.500000
CN1707700000000,17,077,"Jackson County, IL",2014,27791,25969,1822,6.600000
CN1707900000000,17,079,"Jasper County, IL",2014,4736,4431,305,6.400000
CN1708100000000,17,081,"Jefferson County, IL",2014,17591,16278,1313,7.500000
CN1708300000000,17,083,"Jersey County, IL",2014,11086,10292,794,7.200000
CN1708500000000,17,085,"Jo Daviess County, IL",2014,11589,10870,719,6.200000
CN1708700000000,17,087,"Johnson County, IL",2014,4133,3729,404,9.800000
CN1708900000000,17,089,"Kane County, IL",2014,263989,245617,18372,7.000000
CN1709100000000,17,091,"Kankakee County, IL",2014,55367,50883,4484,8.100000
CN1709300000000,17,093,"Kendall County, IL",2014,64498,60407,4091,6.300000
CN1709500000000,17,095,"Knox County, IL",2014,23483,21843,1640,7.000000
CN1709700000000,17,097,"Lake County, IL",2014,366147,342289,23858,6.500000
CN1709900000000,17,099,"LaSalle County, IL",2014,57094,52377,4717,8.300000
CN1710100000000,17,101,"Lawrence County, IL",2014,6352,5871,481,7.600000
CN1710300000000,17,103,"Lee County, IL",2014,18153,16975,1178,6.500000
CN1710500000000,17,105,"Livingston County, IL",2014,17576,16444,1132,6.400000
CN1710700000000,17,107,"Logan County, IL",2014,13097,12248,849,6.500000
CN1710900000000,17,109,"McDonough County, IL",2014,14295,13304,991,6.900000
CN1711100000000,17,111,"McHenry County, IL",2014,166668,156033,10635,6.400000
CN1711300000000,17,113,"McLean County, IL",2014,90929,85893,5036,5.500000
CN1711500000000,17,115,"Macon County, IL",2014,50806,46400,4406,8.700000
CN1711700000000,17,117,"Macoupin County, IL",2014,23283,21550,1733,7.400000
CN1711900000000,17,119,"Madison County, IL",2014,132323,122984,9339,7.100000
CN1712100000000,17,121,"Marion County, IL",2014,17872,16478,1394,7.800000
CN1712300000000,17,123,"Marshall County, IL",2014,5787,5384,403,7.000000
CN1712500000000,17,125,"Mason County, IL",2014,6632,6054,578,8.700000
CN1712700000000,17,127,"Massac County, IL",2014,6350,5841,509,8.000000
CN1712900000000,17,129,"Menard County, IL",2014,6733,6347,386,5.700000
CN1713100000000,17,131,"Mercer County, IL",2014,8394,7805,589,7.000000
CN1713300000000,17,133,"Monroe County, IL",2014,17727,16764,963,5.400000
CN1713500000000,17,135,"Montgomery County, IL",2014,12283,11203,1080,8.800000
CN1713700000000,17,137,"Morgan County, IL",2014,17199,16139,1060,6.200000
CN1713900000000,17,139,"Moultrie County, IL",2014,7062,6676,386,5.500000
CN1714100000000,17,141,"Ogle County, IL",2014,25530,23579,1951,7.600000
CN1714300000000,17,143,"Peoria County, IL",2014,91630,84525,7105,7.800000
CN1714500000000,17,145,"Perry County, IL",2014,8857,8092,765,8.600000
CN1714700000000,17,147,"Piatt County, IL",2014,8394,7909,485,5.800000
CN1714900000000,17,149,"Pike County, IL",2014,7798,7347,451,5.800000
CN1715100000000,17,151,"Pope County, IL",2014,1800,1653,147,8.200000
CN1715300000000,17,153,"Pulaski County, IL",2014,2164,1940,224,10.400000
CN1715500000000,17,155,"Putnam County, IL",2014,3047,2808,239,7.800000
CN1715700000000,17,157,"Randolph County, IL",2014,14130,13177,953,6.700000
CN1715900000000,17,159,"Richland County, IL",2014,7141,6658,483,6.800000
CN1716100000000,17,161,"Rock Island County, IL",2014,73101,67942,5159,7.100000
CN1716300000000,17,163,"St. Clair County, IL",2014,126821,116777,10044,7.900000
CN1716500000000,17,165,"Saline County, IL",2014,10909,10020,889,8.100000
CN1716700000000,17,167,"Sangamon County, IL",2014,103918,97676,6242,6.000000
CN1716900000000,17,169,"Schuyler County, IL",2014,3541,3310,231,6.500000
CN1717100000000,17,171,"Scott County, IL",2014,2571,2395,176,6.800000
CN1717300000000,17,173,"Shelby County, IL",2014,10109,9407,702,6.900000
CN1717500000000,17,175,"Stark County, IL",2014,2833,2620,213,7.500000
CN1717700000000,17,177,"Stephenson County, IL",2014,22265,20594,1671,7.500000
CN1717900000000,17,179,"Tazewell County, IL",2014,67781,63155,4626,6.800000
CN1718100000000,17,181,"Union County, IL",2014,7223,6573,650,9.000000
CN1718300000000,17,183,"Vermilion County, IL",2014,35643,32584,3059,8.600000
CN1718500000000,17,185,"Wabash County, IL",2014,5558,5219,339,6.100000
CN1718700000000,17,187,"Warren County, IL",2014,8714,8198,516,5.900000
CN1718900000000,17,189,"Washington County, IL",2014,9069,8627,442,4.900000
CN1719100000000,17,191,"Wayne County, IL",2014,7685,7171,514,6.700000
CN1719300000000,17,193,"White County, IL",2014,7042,6616,426,6.000000
CN1719500000000,17,195,"Whiteside County, IL",2014,28598,26570,2028,7.100000
CN1719700000000,17,197,"Will County, IL",2014,357282,330751,26531,7.400000
CN1719900000000,17,199,"Williamson County, IL",2014,30556,28309,2247,7.400000
CN1720100000000,17,201,"Winnebago County, IL",2014,142408,130532,11876,8.300000
CN1720300000000,17,203,"Woodford County, IL",2014,19635,18535,1100,5.600000
CN1800100000000,18,001,"Adams County, IN",2014,16386,15612,774,4.700000
CN1800300000000,18,003,"Allen County, IN",2014,175530,165370,10160,5.800000
CN1800500000000,18,005,"Bartholomew County, IN",2014,42798,40892,1906,4.500000
CN1800700000000,18,007,"Benton County, IN",2014,4561,4311,250,5.500000
CN1800900000000,18,009,"Blackford County, IN",2014,5297,4902,395,7.500000
CN1801100000000,18,011,"Boone County, IN",2014,31774,30346,1428,4.500000
CN1801300000000,18,013,"Brown County, IN",2014,7461,7011,450,6.000000
CN1801500000000,18,015,"Carroll County, IN",2014,10082,9550,532,5.300000
CN1801700000000,18,017,"Cass County, IN",2014,17831,16795,1036,5.800000
CN1801900000000,18,019,"Clark County, IN",2014,57432,54288,3144,5.500000
CN1802100000000,18,021,"Clay County, IN",2014,12482,11626,856,6.900000
CN1802300000000,18,023,"Clinton County, IN",2014,16665,15789,876,5.300000
CN1802500000000,18,025,"Crawford County, IN",2014,4908,4529,379,7.700000
CN1802700000000,18,027,"Daviess County, IN",2014,15149,14460,689,4.500000
CN1802900000000,18,029,"Dearborn County, IN",2014,25449,23801,1648,6.500000
CN1803100000000,18,031,"Decatur County, IN",2014,14254,13540,714,5.000000
CN1803300000000,18,033,"DeKalb County, IN",2014,21229,20099,1130,5.300000
CN1803500000000,18,035,"Delaware County, IN",2014,53717,49896,3821,7.100000
CN1803700000000,18,037,"Dubois County, IN",2014,22027,21112,915,4.200000
CN1803900000000,18,039,"Elkhart County, IN",2014,102117,96812,5305,5.200000
CN1804100000000,18,041,"Fayette County, IN",2014,9124,8395,729,8.000000
CN1804300000000,18,043,"Floyd County, IN",2014,39447,37407,2040,5.200000
CN1804500000000,18,045,"Fountain County, IN",2014,8224,7643,581,7.100000
CN1804700000000,18,047,"Franklin County, IN",2014,10846,10140,706,6.500000
CN1804900000000,18,049,"Fulton County, IN",2014,9838,9216,622,6.300000
CN1805100000000,18,051,"Gibson County, IN",2014,18502,17654,848,4.600000
CN1805300000000,18,053,"Grant County, IN",2014,32723,30439,2284,7.000000
CN1805500000000,18,055,"Greene County, IN",2014,13788,12688,1100,8.000000
CN1805700000000,18,057,"Hamilton County, IN",2014,159577,153000,6577,4.100000
CN1805900000000,18,059,"Hancock County, IN",2014,36754,34852,1902,5.200000
CN1806100000000,18,061,"Harrison County, IN",2014,19135,18052,1083,5.700000
CN1806300000000,18,063,"Hendricks County, IN",2014,80397,76644,3753,4.700000
CN1806500000000,18,065,"Henry County, IN",2014,21527,20047,1480,6.900000
CN1806700000000,18,067,"Howard County, IN",2014,37099,34739,2360,6.400000
CN1806900000000,18,069,"Huntington County, IN",2014,18590,17506,1084,5.800000
CN1807100000000,18,071,"Jackson County, IN",2014,21289,20212,1077,5.100000
CN1807300000000,18,073,"Jasper County, IN",2014,16112,15013,1099,6.800000
CN1807500000000,18,075,"Jay County, IN",2014,10194,9602,592,5.800000
CN1807700000000,18,077,"Jefferson County, IN",2014,15196,14279,917,6.000000
CN1807900000000,18,079,"Jennings County, IN",2014,13072,12180,892,6.800000
CN1808100000000,18,081,"Johnson County, IN",2014,75262,71472,3790,5.000000
CN1808300000000,18,083,"Knox County, IN",2014,18845,17845,1000,5.300000
CN1808500000000,18,085,"Kosciusko County, IN",2014,40312,38323,1989,4.900000
CN1808700000000,18,087,"LaGrange County, IN",2014,18154,17328,826,4.500000
CN1808900000000,18,089,"Lake County, IN",2014,231350,212714,18636,8.100000
CN1809100000000,18,091,"LaPorte County, IN",2014,48934,45155,3779,7.700000
CN1809300000000,18,093,"Lawrence County, IN",2014,20463,18786,1677,8.200000
CN1809500000000,18,095,"Madison County, IN",2014,58691,54498,4193,7.100000
CN1809700000000,18,097,"Marion County, IN",2014,468845,438483,30362,6.500000
CN1809900000000,18,099,"Marshall County, IN",2014,23669,22346,1323,5.600000
CN1810100000000,18,101,"Martin County, IN",2014,4968,4702,266,5.400000
CN1810300000000,18,103,"Miami County, IN",2014,15760,14692,1068,6.800000
CN1810500000000,18,105,"Monroe County, IN",2014,67249,63342,3907,5.800000
CN1810700000000,18,107,"Montgomery County, IN",2014,18633,17601,1032,5.500000
CN1810900000000,18,109,"Morgan County, IN",2014,35384,33319,2065,5.800000
CN1811100000000,18,111,"Newton County, IN",2014,6915,6429,486,7.000000
CN1811300000000,18,113,"Noble County, IN",2014,23104,21879,1225,5.300000
CN1811500000000,18,115,"Ohio County, IN",2014,3218,2996,222,6.900000
CN1811700000000,18,117,"Orange County, IN",2014,8534,7874,660,7.700000
CN1811900000000,18,119,"Owen County, IN",2014,9635,8859,776,8.100000
CN1812100000000,18,121,"Parke County, IN",2014,6951,6465,486,7.000000
CN1812300000000,18,123,"Perry County, IN",2014,9157,8614,543,5.900000
CN1812500000000,18,125,"Pike County, IN",2014,6447,6118,329,5.100000
CN1812700000000,18,127,"Porter County, IN",2014,83829,78511,5318,6.300000
CN1812900000000,18,129,"Posey County, IN",2014,13172,12529,643,4.900000
CN1813100000000,18,131,"Pulaski County, IN",2014,6189,5851,338,5.500000
CN1813300000000,18,133,"Putnam County, IN",2014,16357,15287,1070,6.500000
CN1813500000000,18,135,"Randolph County, IN",2014,12542,11717,825,6.600000
CN1813700000000,18,137,"Ripley County, IN",2014,13641,12726,915,6.700000
CN1813900000000,18,139,"Rush County, IN",2014,8524,8047,477,5.600000
CN1814100000000,18,141,"St. Joseph County, IN",2014,128906,120259,8647,6.700000
CN1814300000000,18,143,"Scott County, IN",2014,10369,9674,695,6.700000
CN1814500000000,18,145,"Shelby County, IN",2014,22714,21435,1279,5.600000
CN1814700000000,18,147,"Spencer County, IN",2014,10753,10185,568,5.300000
CN1814900000000,18,149,"Starke County, IN",2014,10246,9485,761,7.400000
CN1815100000000,18,151,"Steuben County, IN",2014,19930,18924,1006,5.000000
CN1815300000000,18,153,"Sullivan County, IN",2014,8687,8045,642,7.400000
CN1815500000000,18,155,"Switzerland County, IN",2014,4824,4541,283,5.900000
CN1815700000000,18,157,"Tippecanoe County, IN",2014,91071,86421,4650,5.100000
CN1815900000000,18,159,"Tipton County, IN",2014,8144,7699,445,5.500000
CN1816100000000,18,161,"Union County, IN",2014,3581,3379,202,5.600000
CN1816300000000,18,163,"Vanderburgh County, IN",2014,92094,87043,5051,5.500000
CN1816500000000,18,165,"Vermillion County, IN",2014,7277,6642,635,8.700000
CN1816700000000,18,167,"Vigo County, IN",2014,49306,45461,3845,7.800000
CN1816900000000,18,169,"Wabash County, IN",2014,15441,14570,871,5.600000
CN1817100000000,18,171,"Warren County, IN",2014,4121,3871,250,6.100000
CN1817300000000,18,173,"Warrick County, IN",2014,31233,29680,1553,5.000000
CN1817500000000,18,175,"Washington County, IN",2014,13369,12480,889,6.600000
CN1817700000000,18,177,"Wayne County, IN",2014,31047,28980,2067,6.700000
CN1817900000000,18,179,"Wells County, IN",2014,13836,13160,676,4.900000
CN1818100000000,18,181,"White County, IN",2014,13371,12671,700,5.200000
CN1818300000000,18,183,"Whitley County, IN",2014,16910,16024,886,5.200000
CN1900100000000,19,001,"Adair County, IA",2014,4175,4000,175,4.200000
CN1900300000000,19,003,"Adams County, IA",2014,2218,2140,78,3.500000
CN1900500000000,19,005,"Allamakee County, IA",2014,7777,7320,457,5.900000
CN1900700000000,19,007,"Appanoose County, IA",2014,6173,5805,368,6.000000
CN1900900000000,19,009,"Audubon County, IA",2014,3306,3158,148,4.500000
CN1901100000000,19,011,"Benton County, IA",2014,13900,13234,666,4.800000
CN1901300000000,19,013,"Black Hawk County, IA",2014,72478,68780,3698,5.100000
CN1901500000000,19,015,"Boone County, IA",2014,15248,14711,537,3.500000
CN1901700000000,19,017,"Bremer County, IA",2014,14215,13671,544,3.800000
CN1901900000000,19,019,"Buchanan County, IA",2014,11528,10972,556,4.800000
CN1902100000000,19,021,"Buena Vista County, IA",2014,11532,11056,476,4.100000
CN1902300000000,19,023,"Butler County, IA",2014,8410,8038,372,4.400000
CN1902500000000,19,025,"Calhoun County, IA",2014,4433,4208,225,5.100000
CN1902700000000,19,027,"Carroll County, IA",2014,11293,10921,372,3.300000
CN1902900000000,19,029,"Cass County, IA",2014,7430,7094,336,4.500000
CN1903100000000,19,031,"Cedar County, IA",2014,10938,10498,440,4.000000
CN1903300000000,19,033,"Cerro Gordo County, IA",2014,23373,22242,1131,4.800000
CN1903500000000,19,035,"Cherokee County, IA",2014,6680,6324,356,5.300000
CN1903700000000,19,037,"Chickasaw County, IA",2014,6541,6219,322,4.900000
CN1903900000000,19,039,"Clarke County, IA",2014,4729,4508,221,4.700000
CN1904100000000,19,041,"Clay County, IA",2014,8989,8601,388,4.300000
CN1904300000000,19,043,"Clayton County, IA",2014,10254,9723,531,5.200000
CN1904500000000,19,045,"Clinton County, IA",2014,24855,23492,1363,5.500000
CN1904700000000,19,047,"Crawford County, IA",2014,8772,8399,373,4.300000
CN1904900000000,19,049,"Dallas County, IA",2014,42082,40646,1436,3.400000
CN1905100000000,19,051,"Davis County, IA",2014,4142,3922,220,5.300000
CN1905300000000,19,053,"Decatur County, IA",2014,4461,4287,174,3.900000
CN1905500000000,19,055,"Delaware County, IA",2014,10585,10167,418,3.900000
CN1905700000000,19,057,"Des Moines County, IA",2014,20968,19879,1089,5.200000
CN1905900000000,19,059,"Dickinson County, IA",2014,9770,9296,474,4.900000
CN1906100000000,19,061,"Dubuque County, IA",2014,55858,53471,2387,4.300000
CN1906300000000,19,063,"Emmet County, IA",2014,5736,5498,238,4.100000
CN1906500000000,19,065,"Fayette County, IA",2014,10860,10294,566,5.200000
CN1906700000000,19,067,"Floyd County, IA",2014,8391,7993,398,4.700000
CN1906900000000,19,069,"Franklin County, IA",2014,6034,5784,250,4.100000
CN1907100000000,19,071,"Fremont County, IA",2014,4184,4014,170,4.100000
CN1907300000000,19,073,"Greene County, IA",2014,5340,5119,221,4.100000
CN1907500000000,19,075,"Grundy County, IA",2014,6736,6442,294,4.400000
CN1907700000000,19,077,"Guthrie County, IA",2014,5701,5445,256,4.500000
CN1907900000000,19,079,"Hamilton County, IA",2014,7146,6807,339,4.700000
CN1908100000000,19,081,"Hancock County, IA",2014,6329,6112,217,3.400000
CN1908300000000,19,083,"Hardin County, IA",2014,8782,8389,393,4.500000
CN1908500000000,19,085,"Harrison County, IA",2014,7691,7373,318,4.100000
CN1908700000000,19,087,"Henry County, IA",2014,9596,9158,438,4.600000
CN1908900000000,19,089,"Howard County, IA",2014,5363,5136,227,4.200000
CN1909100000000,19,091,"Humboldt County, IA",2014,5284,5075,209,4.000000
CN1909300000000,19,093,"Ida County, IA",2014,3915,3768,147,3.800000
CN1909500000000,19,095,"Iowa County, IA",2014,10266,9820,446,4.300000
CN1909700000000,19,097,"Jackson County, IA",2014,11042,10460,582,5.300000
CN1909900000000,19,099,"Jasper County, IA",2014,19463,18567,896,4.600000
CN1910100000000,19,101,"Jefferson County, IA",2014,9104,8695,409,4.500000
CN1910300000000,19,103,"Johnson County, IA",2014,84241,81572,2669,3.200000
CN1910500000000,19,105,"Jones County, IA",2014,10903,10343,560,5.100000
CN1910700000000,19,107,"Keokuk County, IA",2014,5598,5342,256,4.600000
CN1910900000000,19,109,"Kossuth County, IA",2014,8690,8398,292,3.400000
CN1911100000000,19,111,"Lee County, IA",2014,17693,16585,1108,6.300000
CN1911300000000,19,113,"Linn County, IA",2014,120339,114818,5521,4.600000
CN1911500000000,19,115,"Louisa County, IA",2014,5965,5685,280,4.700000
CN1911700000000,19,117,"Lucas County, IA",2014,4323,4147,176,4.100000
CN1911900000000,19,119,"Lyon County, IA",2014,7074,6887,187,2.600000
CN1912100000000,19,121,"Madison County, IA",2014,8320,7931,389,4.700000
CN1912300000000,19,123,"Mahaska County, IA",2014,11938,11394,544,4.600000
CN1912500000000,19,125,"Marion County, IA",2014,17534,16840,694,4.000000
CN1912700000000,19,127,"Marshall County, IA",2014,20008,18888,1120,5.600000
CN1912900000000,19,129,"Mills County, IA",2014,7528,7190,338,4.500000
CN1913100000000,19,131,"Mitchell County, IA",2014,5522,5320,202,3.700000
CN1913300000000,19,133,"Monona County, IA",2014,4790,4541,249,5.200000
CN1913500000000,19,135,"Monroe County, IA",2014,4109,3894,215,5.200000
CN1913700000000,19,137,"Montgomery County, IA",2014,5187,4964,223,4.300000
CN1913900000000,19,139,"Muscatine County, IA",2014,22164,21118,1046,4.700000
CN1914100000000,19,141,"O'Brien County, IA",2014,8230,7948,282,3.400000
CN1914300000000,19,143,"Osceola County, IA",2014,3461,3341,120,3.500000
CN1914500000000,19,145,"Page County, IA",2014,6639,6331,308,4.600000
CN1914700000000,19,147,"Palo Alto County, IA",2014,4859,4675,184,3.800000
CN1914900000000,19,149,"Plymouth County, IA",2014,14827,14301,526,3.500000
CN1915100000000,19,151,"Pocahontas County, IA",2014,4383,4225,158,3.600000
CN1915300000000,19,153,"Polk County, IA",2014,256666,245459,11207,4.400000
CN1915500000000,19,155,"Pottawattamie County, IA",2014,49647,47450,2197,4.400000
CN1915700000000,19,157,"Poweshiek County, IA",2014,10379,9917,462,4.500000
CN1915900000000,19,159,"Ringgold County, IA",2014,2548,2446,102,4.000000
CN1916100000000,19,161,"Sac County, IA",2014,5585,5357,228,4.100000
CN1916300000000,19,163,"Scott County, IA",2014,88327,83519,4808,5.400000
CN1916500000000,19,165,"Shelby County, IA",2014,7068,6838,230,3.300000
CN1916700000000,19,167,"Sioux County, IA",2014,20260,19644,616,3.000000
CN1916900000000,19,169,"Story County, IA",2014,56826,55157,1669,2.900000
CN1917100000000,19,171,"Tama County, IA",2014,9217,8705,512,5.600000
CN1917300000000,19,173,"Taylor County, IA",2014,3266,3141,125,3.800000
CN1917500000000,19,175,"Union County, IA",2014,6858,6522,336,4.900000
CN1917700000000,19,177,"Van Buren County, IA",2014,3926,3741,185,4.700000
CN1917900000000,19,179,"Wapello County, IA",2014,18264,17218,1046,5.700000
CN1918100000000,19,181,"Warren County, IA",2014,26998,25898,1100,4.100000
CN1918300000000,19,183,"Washington County, IA",2014,12576,12113,463,3.700000
CN1918500000000,19,185,"Wayne County, IA",2014,2896,2745,151,5.200000
CN1918700000000,19,187,"Webster County, IA",2014,19887,18884,1003,5.000000
CN1918900000000,19,189,"Winnebago County, IA",2014,5256,5026,230,4.400000
CN1919100000000,19,191,"Winneshiek County, IA",2014,12149,11612,537,4.400000
CN1919300000000,19,193,"Woodbury County, IA",2014,56358,53795,2563,4.500000
CN1919500000000,19,195,"Worth County, IA",2014,4224,4026,198,4.700000
CN1919700000000,19,197,"Wright County, IA",2014,7006,6707,299,4.300000
CN2000100000000,20,001,"Allen County, KS",2014,6964,6617,347,5.000000
CN2000300000000,20,003,"Anderson County, KS",2014,4250,4034,216,5.100000
CN2000500000000,20,005,"Atchison County, KS",2014,7714,7216,498,6.500000
CN2000700000000,20,007,"Barber County, KS",2014,2717,2632,85,3.100000
CN2000900000000,20,009,"Barton County, KS",2014,15618,15065,553,3.500000
CN2001100000000,20,011,"Bourbon County, KS",2014,7110,6739,371,5.200000
CN2001300000000,20,013,"Brown County, KS",2014,5451,5227,224,4.100000
CN2001500000000,20,015,"Butler County, KS",2014,32034,30470,1564,4.900000
CN2001700000000,20,017,"Chase County, KS",2014,1253,1203,50,4.000000
CN2001900000000,20,019,"Chautauqua County, KS",2014,1605,1517,88,5.500000
CN2002100000000,20,021,"Cherokee County, KS",2014,10385,9862,523,5.000000
CN2002300000000,20,023,"Cheyenne County, KS",2014,1312,1271,41,3.100000
CN2002500000000,20,025,"Clark County, KS",2014,1154,1123,31,2.700000
CN2002700000000,20,027,"Clay County, KS",2014,4250,4064,186,4.400000
CN2002900000000,20,029,"Cloud County, KS",2014,4439,4253,186,4.200000
CN2003100000000,20,031,"Coffey County, KS",2014,5010,4731,279,5.600000
CN2003300000000,20,033,"Comanche County, KS",2014,971,941,30,3.100000
CN2003500000000,20,035,"Cowley County, KS",2014,17382,16577,805,4.600000
CN2003700000000,20,037,"Crawford County, KS",2014,19312,18286,1026,5.300000
CN2003900000000,20,039,"Decatur County, KS",2014,1333,1285,48,3.600000
CN2004100000000,20,041,"Dickinson County, KS",2014,9933,9437,496,5.000000
CN2004300000000,20,043,"Doniphan County, KS",2014,4321,4126,195,4.500000
CN2004500000000,20,045,"Douglas County, KS",2014,64754,62128,2626,4.100000
CN2004700000000,20,047,"Edwards County, KS",2014,1606,1554,52,3.200000
CN2004900000000,20,049,"Elk County, KS",2014,1310,1244,66,5.000000
CN2005100000000,20,051,"Ellis County, KS",2014,18201,17703,498,2.700000
CN2005300000000,20,053,"Ellsworth County, KS",2014,3437,3334,103,3.000000
CN2005500000000,20,055,"Finney County, KS",2014,20340,19644,696,3.400000
CN2005700000000,20,057,"Ford County, KS",2014,18486,17790,696,3.800000
CN2005900000000,20,059,"Franklin County, KS",2014,14173,13444,729,5.100000
CN2006100000000,20,061,"Geary County, KS",2014,12407,11532,875,7.100000
CN2006300000000,20,063,"Gove County, KS",2014,1501,1461,40,2.700000
CN2006500000000,20,065,"Graham County, KS",2014,1327,1282,45,3.400000
CN2006700000000,20,067,"Grant County, KS",2014,3969,3834,135,3.400000
CN2006900000000,20,069,"Gray County, KS",2014,3503,3409,94,2.700000
CN2007100000000,20,071,"Greeley County, KS",2014,896,877,19,2.100000
CN2007300000000,20,073,"Greenwood County, KS",2014,3337,3186,151,4.500000
CN2007500000000,20,075,"Hamilton County, KS",2014,1687,1648,39,2.300000
CN2007700000000,20,077,"Harper County, KS",2014,3019,2908,111,3.700000
CN2007900000000,20,079,"Harvey County, KS",2014,17225,16494,731,4.200000
CN2008100000000,20,081,"Haskell County, KS",2014,2396,2334,62,2.600000
CN2008300000000,20,083,"Hodgeman County, KS",2014,1050,1014,36,3.400000
CN2008500000000,20,085,"Jackson County, KS",2014,7350,7042,308,4.200000
CN2008700000000,20,087,"Jefferson County, KS",2014,10271,9771,500,4.900000
CN2008900000000,20,089,"Jewell County, KS",2014,1386,1331,55,4.000000
CN2009100000000,20,091,"Johnson County, KS",2014,321092,308995,12097,3.800000
CN2009300000000,20,093,"Kearny County, KS",2014,2139,2074,65,3.000000
CN2009500000000,20,095,"Kingman County, KS",2014,3700,3554,146,3.900000
CN2009700000000,20,097,"Kiowa County, KS",2014,1364,1318,46,3.400000
CN2009900000000,20,099,"Labette County, KS",2014,10834,10199,635,5.900000
CN2010100000000,20,101,"Lane County, KS",2014,868,840,28,3.200000
CN2010300000000,20,103,"Leavenworth County, KS",2014,35210,33454,1756,5.000000
CN2010500000000,20,105,"Lincoln County, KS",2014,1774,1701,73,4.100000
CN2010700000000,20,107,"Linn County, KS",2014,4372,4056,316,7.200000
CN2010900000000,20,109,"Logan County, KS",2014,1750,1711,39,2.200000
CN2011100000000,20,111,"Lyon County, KS",2014,16396,15543,853,5.200000
CN2011300000000,20,113,"McPherson County, KS",2014,16954,16400,554,3.300000
CN2011500000000,20,115,"Marion County, KS",2014,6178,5926,252,4.100000
CN2011700000000,20,117,"Marshall County, KS",2014,5975,5783,192,3.200000
CN2011900000000,20,119,"Meade County, KS",2014,2427,2364,63,2.600000
CN2012100000000,20,121,"Miami County, KS",2014,17093,16290,803,4.700000
CN2012300000000,20,123,"Mitchell County, KS",2014,3873,3746,127,3.300000
CN2012500000000,20,125,"Montgomery County, KS",2014,17453,16441,1012,5.800000
CN2012700000000,20,127,"Morris County, KS",2014,3134,2995,139,4.400000
CN2012900000000,20,129,"Morton County, KS",2014,1514,1454,60,4.000000
CN2013100000000,20,131,"Nemaha County, KS",2014,5857,5689,168,2.900000
CN2013300000000,20,133,"Neosho County, KS",2014,6449,5982,467,7.200000
CN2013500000000,20,135,"Ness County, KS",2014,1621,1577,44,2.700000
CN2013700000000,20,137,"Norton County, KS",2014,3103,3029,74,2.400000
CN2013900000000,20,139,"Osage County, KS",2014,8304,7851,453,5.500000
CN2014100000000,20,141,"Osborne County, KS",2014,2056,1977,79,3.800000
CN2014300000000,20,143,"Ottawa County, KS",2014,3267,3132,135,4.100000
CN2014500000000,20,145,"Pawnee County, KS",2014,3440,3310,130,3.800000
CN2014700000000,20,147,"Phillips County, KS",2014,2951,2848,103,3.500000
CN2014900000000,20,149,"Pottawatomie County, KS",2014,11999,11529,470,3.900000
CN2015100000000,20,151,"Pratt County, KS",2014,5484,5304,180,3.300000
CN2015300000000,20,153,"Rawlins County, KS",2014,1525,1487,38,2.500000
CN2015500000000,20,155,"Reno County, KS",2014,31488,30104,1384,4.400000
CN2015700000000,20,157,"Republic County, KS",2014,2591,2512,79,3.000000
CN2015900000000,20,159,"Rice County, KS",2014,5455,5261,194,3.600000
CN2016100000000,20,161,"Riley County, KS",2014,36908,35549,1359,3.700000
CN2016300000000,20,163,"Rooks County, KS",2014,2870,2766,104,3.600000
CN2016500000000,20,165,"Rush County, KS",2014,1828,1763,65,3.600000
CN2016700000000,20,167,"Russell County, KS",2014,3886,3750,136,3.500000
CN2016900000000,20,169,"Saline County, KS",2014,30945,29647,1298,4.200000
CN2017100000000,20,171,"Scott County, KS",2014,2858,2780,78,2.700000
CN2017300000000,20,173,"Sedgwick County, KS",2014,247614,234277,13337,5.400000
CN2017500000000,20,175,"Seward County, KS",2014,11262,10867,395,3.500000
CN2017700000000,20,177,"Shawnee County, KS",2014,92755,88339,4416,4.800000
CN2017900000000,20,179,"Sheridan County, KS",2014,1493,1454,39,2.600000
CN2018100000000,20,181,"Sherman County, KS",2014,3081,2982,99,3.200000
CN2018300000000,20,183,"Smith County, KS",2014,2119,2053,66,3.100000
CN2018500000000,20,185,"Stafford County, KS",2014,2207,2125,82,3.700000
CN2018700000000,20,187,"Stanton County, KS",2014,1039,1004,35,3.400000
CN2018900000000,20,189,"Stevens County, KS",2014,3544,3442,102,2.900000
CN2019100000000,20,191,"Sumner County, KS",2014,11195,10660,535,4.800000
CN2019300000000,20,193,"Thomas County, KS",2014,4487,4359,128,2.900000
CN2019500000000,20,195,"Trego County, KS",2014,1505,1458,47,3.100000
CN2019700000000,20,197,"Wabaunsee County, KS",2014,3801,3644,157,4.100000
CN2019900000000,20,199,"Wallace County, KS",2014,898,874,24,2.700000
CN2020100000000,20,201,"Washington County, KS",2014,3116,3015,101,3.200000
CN2020300000000,20,203,"Wichita County, KS",2014,1248,1213,35,2.800000
CN2020500000000,20,205,"Wilson County, KS",2014,4175,3896,279,6.700000
CN2020700000000,20,207,"Woodson County, KS",2014,1636,1550,86,5.300000
CN2020900000000,20,209,"Wyandotte County, KS",2014,76050,70820,5230,6.900000
CN2100100000000,21,001,"Adair County, KY",2014,7206,6611,595,8.300000
CN2100300000000,21,003,"Allen County, KY",2014,8766,8245,521,5.900000
CN2100500000000,21,005,"Anderson County, KY",2014,11317,10714,603,5.300000
CN2100700000000,21,007,"Ballard County, KY",2014,3694,3401,293,7.900000
CN2100900000000,21,009,"Barren County, KY",2014,18827,17632,1195,6.300000
CN2101100000000,21,011,"Bath County, KY",2014,4635,4216,419,9.000000
CN2101300000000,21,013,"Bell County, KY",2014,9298,8349,949,10.200000
CN2101500000000,21,015,"Boone County, KY",2014,64609,61243,3366,5.200000
CN2101700000000,21,017,"Bourbon County, KY",2014,9720,9170,550,5.700000
CN2101900000000,21,019,"Boyd County, KY",2014,18876,17470,1406,7.400000
CN2102100000000,21,021,"Boyle County, KY",2014,12227,11373,854,7.000000
CN2102300000000,21,023,"Bracken County, KY",2014,3822,3522,300,7.800000
CN2102500000000,21,025,"Breathitt County, KY",2014,4185,3700,485,11.600000
CN2102700000000,21,027,"Breckinridge County, KY",2014,8074,7498,576,7.100000
CN2102900000000,21,029,"Bullitt County, KY",2014,38948,36668,2280,5.900000
CN2103100000000,21,031,"Butler County, KY",2014,5227,4842,385,7.400000
CN2103300000000,21,033,"Caldwell County, KY",2014,5472,5115,357,6.500000
CN2103500000000,21,035,"Calloway County, KY",2014,18652,17584,1068,5.700000
CN2103700000000,21,037,"Campbell County, KY",2014,47729,45229,2500,5.200000
CN2103900000000,21,039,"Carlisle County, KY",2014,2355,2211,144,6.100000
CN2104100000000,21,041,"Carroll County, KY",2014,4858,4507,351,7.200000
CN2104300000000,21,043,"Carter County, KY",2014,10457,9327,1130,10.800000
CN2104500000000,21,045,"Casey County, KY",2014,6573,6114,459,7.000000
CN2104700000000,21,047,"Christian County, KY",2014,25951,23984,1967,7.600000
CN2104900000000,21,049,"Clark County, KY",2014,17020,15974,1046,6.100000
CN2105100000000,21,051,"Clay County, KY",2014,5531,4896,635,11.500000
CN2105300000000,21,053,"Clinton County, KY",2014,3990,3627,363,9.100000
CN2105500000000,21,055,"Crittenden County, KY",2014,3913,3672,241,6.200000
CN2105700000000,21,057,"Cumberland County, KY",2014,2956,2730,226,7.600000
CN2105900000000,21,059,"Daviess County, KY",2014,45980,43366,2614,5.700000
CN2106100000000,21,061,"Edmonson County, KY",2014,4870,4468,402,8.300000
CN2106300000000,21,063,"Elliott County, KY",2014,2147,1901,246,11.500000
CN2106500000000,21,065,"Estill County, KY",2014,5399,4995,404,7.500000
CN2106700000000,21,067,"Fayette County, KY",2014,166862,158803,8059,4.800000
CN2106900000000,21,069,"Fleming County, KY",2014,6331,5831,500,7.900000
CN2107100000000,21,071,"Floyd County, KY",2014,12445,11158,1287,10.300000
CN2107300000000,21,073,"Franklin County, KY",2014,24092,22794,1298,5.400000
CN2107500000000,21,075,"Fulton County, KY",2014,2252,2063,189,8.400000
CN2107700000000,21,077,"Gallatin County, KY",2014,3825,3563,262,6.800000
CN2107900000000,21,079,"Garrard County, KY",2014,7591,7088,503,6.600000
CN2108100000000,21,081,"Grant County, KY",2014,11201,10477,724,6.500000
CN2108300000000,21,083,"Graves County, KY",2014,15940,14735,1205,7.600000
CN2108500000000,21,085,"Grayson County, KY",2014,10822,9907,915,8.500000
CN2108700000000,21,087,"Green County, KY",2014,5111,4776,335,6.600000
CN2108900000000,21,089,"Greenup County, KY",2014,14198,13011,1187,8.400000
CN2109100000000,21,091,"Hancock County, KY",2014,3959,3719,240,6.100000
CN2109300000000,21,093,"Hardin County, KY",2014,46567,43658,2909,6.200000
CN2109500000000,21,095,"Harlan County, KY",2014,8536,7353,1183,13.900000
CN2109700000000,21,097,"Harrison County, KY",2014,8404,7896,508,6.000000
CN2109900000000,21,099,"Hart County, KY",2014,7801,7305,496,6.400000
CN2110100000000,21,101,"Henderson County, KY",2014,21640,20314,1326,6.100000
CN2110300000000,21,103,"Henry County, KY",2014,7636,7189,447,5.900000
CN2110500000000,21,105,"Hickman County, KY",2014,2129,1996,133,6.200000
CN2110700000000,21,107,"Hopkins County, KY",2014,20613,19289,1324,6.400000
CN2110900000000,21,109,"Jackson County, KY",2014,4628,4097,531,11.500000
CN2111100000000,21,111,"Jefferson County, KY",2014,378661,355616,23045,6.100000
CN2111300000000,21,113,"Jessamine County, KY",2014,24767,23456,1311,5.300000
CN2111500000000,21,115,"Johnson County, KY",2014,8082,7334,748,9.300000
CN2111700000000,21,117,"Kenton County, KY",2014,83213,78575,4638,5.600000
CN2111900000000,21,119,"Knott County, KY",2014,5149,4573,576,11.200000
CN2112100000000,21,121,"Knox County, KY",2014,10124,9110,1014,10.000000
CN2112300000000,21,123,"Larue County, KY",2014,5714,5340,374,6.500000
CN2112500000000,21,125,"Laurel County, KY",2014,23944,22116,1828,7.600000
CN2112700000000,21,127,"Lawrence County, KY",2014,5314,4802,512,9.600000
CN2112900000000,21,129,"Lee County, KY",2014,2257,2037,220,9.700000
CN2113100000000,21,131,"Leslie County, KY",2014,3193,2784,409,12.800000
CN2113300000000,21,133,"Letcher County, KY",2014,7337,6434,903,12.300000
CN2113500000000,21,135,"Lewis County, KY",2014,5160,4661,499,9.700000
CN2113700000000,21,137,"Lincoln County, KY",2014,9457,8630,827,8.700000
CN2113900000000,21,139,"Livingston County, KY",2014,3733,3429,304,8.100000
CN2114100000000,21,141,"Logan County, KY",2014,11887,11208,679,5.700000
CN2114300000000,21,143,"Lyon County, KY",2014,2999,2792,207,6.900000
CN2114500000000,21,145,"McCracken County, KY",2014,29359,27272,2087,7.100000
CN2114700000000,21,147,"McCreary County, KY",2014,5063,4521,542,10.700000
CN2114900000000,21,149,"McLean County, KY",2014,4336,4054,282,6.500000
CN2115100000000,21,151,"Madison County, KY",2014,44889,42465,2424,5.400000
CN2115300000000,21,153,"Magoffin County, KY",2014,3744,3221,523,14.000000
CN2115500000000,21,155,"Marion County, KY",2014,9062,8477,585,6.500000
CN2115700000000,21,157,"Marshall County, KY",2014,15050,14021,1029,6.800000
CN2115900000000,21,159,"Martin County, KY",2014,3474,3157,317,9.100000
CN2116100000000,21,161,"Mason County, KY",2014,7733,7129,604,7.800000
CN2116300000000,21,163,"Meade County, KY",2014,12142,11287,855,7.000000
CN2116500000000,21,165,"Menifee County, KY",2014,2358,2125,233,9.900000
CN2116700000000,21,167,"Mercer County, KY",2014,9904,9286,618,6.200000
CN2116900000000,21,169,"Metcalfe County, KY",2014,4159,3906,253,6.100000
CN2117100000000,21,171,"Monroe County, KY",2014,4597,4340,257,5.600000
CN2117300000000,21,173,"Montgomery County, KY",2014,11659,10785,874,7.500000
CN2117500000000,21,175,"Morgan County, KY",2014,4826,4370,456,9.400000
CN2117700000000,21,177,"Muhlenberg County, KY",2014,12471,11527,944,7.600000
CN2117900000000,21,179,"Nelson County, KY",2014,21314,20005,1309,6.100000
CN2118100000000,21,181,"Nicholas County, KY",2014,3467,3189,278,8.000000
CN2118300000000,21,183,"Ohio County, KY",2014,9485,8763,722,7.600000
CN2118500000000,21,185,"Oldham County, KY",2014,29948,28515,1433,4.800000
CN2118700000000,21,187,"Owen County, KY",2014,5558,5277,281,5.100000
CN2118900000000,21,189,"Owsley County, KY",2014,1237,1110,127,10.300000
CN2119100000000,21,191,"Pendleton County, KY",2014,6836,6379,457,6.700000
CN2119300000000,21,193,"Perry County, KY",2014,9650,8653,997,10.300000
CN2119500000000,21,195,"Pike County, KY",2014,22098,19787,2311,10.500000
CN2119700000000,21,197,"Powell County, KY",2014,4948,4524,424,8.600000
CN2119900000000,21,199,"Pulaski County, KY",2014,26325,24380,1945,7.400000
CN2120100000000,21,201,"Robertson County, KY",2014,808,746,62,7.700000
CN2120300000000,21,203,"Rockcastle County, KY",2014,6900,6387,513,7.400000
CN2120500000000,21,205,"Rowan County, KY",2014,10512,9781,731,7.000000
CN2120700000000,21,207,"Russell County, KY",2014,6743,6069,674,10.000000
CN2120900000000,21,209,"Scott County, KY",2014,25987,24695,1292,5.000000
CN2121100000000,21,211,"Shelby County, KY",2014,22332,21213,1119,5.000000
CN2121300000000,21,213,"Simpson County, KY",2014,8540,8043,497,5.800000
CN2121500000000,21,215,"Spencer County, KY",2014,9209,8717,492,5.300000
CN2121700000000,21,217,"Taylor County, KY",2014,11134,10310,824,7.400000
CN2121900000000,21,219,"Todd County, KY",2014,5465,5166,299,5.500000
CN2122100000000,21,221,"Trigg County, KY",2014,5890,5482,408,6.900000
CN2122300000000,21,223,"Trimble County, KY",2014,3911,3630,281,7.200000
CN2122500000000,21,225,"Union County, KY",2014,6715,6283,432,6.400000
CN2122700000000,21,227,"Warren County, KY",2014,59281,55988,3293,5.600000
CN2122900000000,21,229,"Washington County, KY",2014,6097,5759,338,5.500000
CN2123100000000,21,231,"Wayne County, KY",2014,7159,6449,710,9.900000
CN2123300000000,21,233,"Webster County, KY",2014,6316,5965,351,5.600000
CN2123500000000,21,235,"Whitley County, KY",2014,13497,12321,1176,8.700000
CN2123700000000,21,237,"Wolfe County, KY",2014,2047,1815,232,11.300000
CN2123900000000,21,239,"Woodford County, KY",2014,14166,13528,638,4.500000
CN2200100000000,22,001,"Acadia Parish, LA",2014,26895,25357,1538,5.700000
CN2200300000000,22,003,"Allen Parish, LA",2014,9038,8388,650,7.200000
CN2200500000000,22,005,"Ascension Parish, LA",2014,58954,55796,3158,5.400000
CN2200700000000,22,007,"Assumption Parish, LA",2014,10124,9354,770,7.600000
CN2200900000000,22,009,"Avoyelles Parish, LA",2014,16266,15085,1181,7.300000
CN2201100000000,22,011,"Beauregard Parish, LA",2014,14822,13809,1013,6.800000
CN2201300000000,22,013,"Bienville Parish, LA",2014,5965,5502,463,7.800000
CN2201500000000,22,015,"Bossier Parish, LA",2014,57661,54307,3354,5.800000
CN2201700000000,22,017,"Caddo Parish, LA",2014,112139,103833,8306,7.400000
CN2201900000000,22,019,"Calcasieu Parish, LA",2014,94601,89004,5597,5.900000
CN2202100000000,22,021,"Caldwell Parish, LA",2014,4095,3782,313,7.600000
CN2202300000000,22,023,"Cameron Parish, LA",2014,3510,3340,170,4.800000
CN2202500000000,22,025,"Catahoula Parish, LA",2014,3856,3544,312,8.100000
CN2202700000000,22,027,"Claiborne Parish, LA",2014,6408,5924,484,7.600000
CN2202900000000,22,029,"Concordia Parish, LA",2014,7874,7189,685,8.700000
CN2203100000000,22,031,"De Soto Parish, LA",2014,11109,10205,904,8.100000
CN2203300000000,22,033,"East Baton Rouge Parish, LA",2014,234099,220583,13516,5.800000
CN2203500000000,22,035,"East Carroll Parish, LA",2014,2238,1906,332,14.800000
CN2203700000000,22,037,"East Feliciana Parish, LA",2014,8242,7707,535,6.500000
CN2203900000000,22,039,"Evangeline Parish, LA",2014,13233,12340,893,6.700000
CN2204100000000,22,041,"Franklin Parish, LA",2014,7613,6891,722,9.500000
CN2204300000000,22,043,"Grant Parish, LA",2014,8352,7757,595,7.100000
CN2204500000000,22,045,"Iberia Parish, LA",2014,32992,30923,2069,6.300000
CN2204700000000,22,047,"Iberville Parish, LA",2014,14536,13398,1138,7.800000
CN2204900000000,22,049,"Jackson Parish, LA",2014,7253,6821,432,6.000000
CN2205100000000,22,051,"Jefferson Parish, LA",2014,219986,206825,13161,6.000000
CN2205300000000,22,053,"Jefferson Davis Parish, LA",2014,13603,12801,802,5.900000
CN2205500000000,22,055,"Lafayette Parish, LA",2014,121654,115656,5998,4.900000
CN2205700000000,22,057,"Lafourche Parish, LA",2014,48594,46256,2338,4.800000
CN2205900000000,22,059,"LaSalle Parish, LA",2014,6780,6432,348,5.100000
CN2206100000000,22,061,"Lincoln Parish, LA",2014,19865,18308,1557,7.800000
CN2206300000000,22,063,"Livingston Parish, LA",2014,66433,62776,3657,5.500000
CN2206500000000,22,065,"Madison Parish, LA",2014,3907,3466,441,11.300000
CN2206700000000,22,067,"Morehouse Parish, LA",2014,11270,10000,1270,11.300000
CN2206900000000,22,069,"Natchitoches Parish, LA",2014,16325,15018,1307,8.000000
CN2207100000000,22,071,"Orleans Parish, LA",2014,178535,166019,12516,7.000000
CN2207300000000,22,073,"Ouachita Parish, LA",2014,72457,67414,5043,7.000000
CN2207500000000,22,075,"Plaquemines Parish, LA",2014,10398,9804,594,5.700000
CN2207700000000,22,077,"Pointe Coupee Parish, LA",2014,10246,9531,715,7.000000
CN2207900000000,22,079,"Rapides Parish, LA",2014,58646,54742,3904,6.700000
CN2208100000000,22,081,"Red River Parish, LA",2014,4047,3751,296,7.300000
CN2208300000000,22,083,"Richland Parish, LA",2014,8784,8036,748,8.500000
CN2208500000000,22,085,"Sabine Parish, LA",2014,9271,8662,609,6.600000
CN2208700000000,22,087,"St. Bernard Parish, LA",2014,19032,17712,1320,6.900000
CN2208900000000,22,089,"St. Charles Parish, LA",2014,25701,24138,1563,6.100000
CN2209100000000,22,091,"St. Helena Parish, LA",2014,4686,4222,464,9.900000
CN2209300000000,22,093,"St. James Parish, LA",2014,9913,9074,839,8.500000
CN2209500000000,22,095,"St. John the Baptist Parish, LA",2014,20566,18968,1598,7.800000
CN2209700000000,22,097,"St. Landry Parish, LA",2014,34223,31639,2584,7.600000
CN2209900000000,22,099,"St. Martin Parish, LA",2014,24835,23415,1420,5.700000
CN2210100000000,22,101,"St. Mary Parish, LA",2014,25555,23938,1617,6.300000
CN2210300000000,22,103,"St. Tammany Parish, LA",2014,114591,108112,6479,5.700000
CN2210500000000,22,105,"Tangipahoa Parish, LA",2014,54165,50104,4061,7.500000
CN2210700000000,22,107,"Tensas Parish, LA",2014,1802,1633,169,9.400000
CN2210900000000,22,109,"Terrebonne Parish, LA",2014,55001,52335,2666,4.800000
CN2211100000000,22,111,"Union Parish, LA",2014,9355,8658,697,7.500000
CN2211300000000,22,113,"Vermilion Parish, LA",2014,26725,25238,1487,5.600000
CN2211500000000,22,115,"Vernon Parish, LA",2014,17615,16132,1483,8.400000
CN2211700000000,22,117,"Washington Parish, LA",2014,17077,15728,1349,7.900000
CN2211900000000,22,119,"Webster Parish, LA",2014,15770,14442,1328,8.400000
CN2212100000000,22,121,"West Baton Rouge Parish, LA",2014,12756,12010,746,5.800000
CN2212300000000,22,123,"West Carroll Parish, LA",2014,4289,3734,555,12.900000
CN2212500000000,22,125,"West Feliciana Parish, LA",2014,5436,5120,316,5.800000
CN2212700000000,22,127,"Winn Parish, LA",2014,5470,5065,405,7.400000
CN2300100000000,23,001,"Androscoggin County, ME",2014,56165,53095,3070,5.500000
CN2300300000000,23,003,"Aroostook County, ME",2014,33120,30587,2533,7.600000
CN2300500000000,23,005,"Cumberland County, ME",2014,159417,152357,7060,4.400000
CN2300700000000,23,007,"Franklin County, ME",2014,15086,14084,1002,6.600000
CN2300900000000,23,009,"Hancock County, ME",2014,29849,27760,2089,7.000000
CN2301100000000,23,011,"Kennebec County, ME",2014,63515,60077,3438,5.400000
CN2301300000000,23,013,"Knox County, ME",2014,20735,19661,1074,5.200000
CN2301500000000,23,015,"Lincoln County, ME",2014,17267,16246,1021,5.900000
CN2301700000000,23,017,"Oxford County, ME",2014,27512,25588,1924,7.000000
CN2301900000000,23,019,"Penobscot County, ME",2014,79253,74325,4928,6.200000
CN2302100000000,23,021,"Piscataquis County, ME",2014,7769,7187,582,7.500000
CN2302300000000,23,023,"Sagadahoc County, ME",2014,19163,18275,888,4.600000
CN2302500000000,23,025,"Somerset County, ME",2014,24520,22575,1945,7.900000
CN2302700000000,23,027,"Waldo County, ME",2014,20902,19622,1280,6.100000
CN2302900000000,23,029,"Washington County, ME",2014,14567,13345,1222,8.400000
CN2303100000000,23,031,"York County, ME",2014,110083,104271,5812,5.300000
CN2400100000000,24,001,"Allegany County, MD",2014,33125,30701,2424,7.300000
CN2400300000000,24,003,"Anne Arundel County, MD",2014,295723,280492,15231,5.200000
CN2400500000000,24,005,"Baltimore County, MD",2014,440393,413083,27310,6.200000
CN2400900000000,24,009,"Calvert County, MD",2014,47581,45078,2503,5.300000
CN2401100000000,24,011,"Caroline County, MD",2014,17487,16381,1106,6.300000
CN2401300000000,24,013,"Carroll County, MD",2014,92613,88090,4523,4.900000
CN2401500000000,24,015,"Cecil County, MD",2014,52078,48665,3413,6.600000
CN2401700000000,24,017,"Charles County, MD",2014,79850,75356,4494,5.600000
CN2401900000000,24,019,"Dorchester County, MD",2014,15820,14476,1344,8.500000
CN2402100000000,24,021,"Frederick County, MD",2014,127636,121138,6498,5.100000
CN2402300000000,24,023,"Garrett County, MD",2014,15458,14389,1069,6.900000
CN2402500000000,24,025,"Harford County, MD",2014,135057,127256,7801,5.800000
CN2402700000000,24,027,"Howard County, MD",2014,171079,163556,7523,4.400000
CN2402900000000,24,029,"Kent County, MD",2014,10190,9525,665,6.500000
CN2403100000000,24,031,"Montgomery County, MD",2014,540128,516420,23708,4.400000
CN2403300000000,24,033,"Prince George's County, MD",2014,482279,453982,28297,5.900000
CN2403500000000,24,035,"Queen Anne's County, MD",2014,26258,24906,1352,5.100000
CN2403700000000,24,037,"St. Mary's County, MD",2014,53908,50995,2913,5.400000
CN2403900000000,24,039,"Somerset County, MD",2014,9461,8563,898,9.500000
CN2404100000000,24,041,"Talbot County, MD",2014,19102,18023,1079,5.600000
CN2404300000000,24,043,"Washington County, MD",2014,76251,71268,4983,6.500000
CN2404500000000,24,045,"Wicomico County, MD",2014,49856,46055,3801,7.600000
CN2404700000000,24,047,"Worcester County, MD",2014,25658,22756,2902,11.300000
CN2451000000000,24,510,"Baltimore city, MD",2014,294340,268824,25516,8.700000
CN2500100000000,25,001,"Barnstable County, MA",2014,111763,103930,7833,7.000000
CN2500300000000,25,003,"Berkshire County, MA",2014,66116,61826,4290,6.500000
CN2500500000000,25,005,"Bristol County, MA",2014,288918,267712,21206,7.300000
CN2500700000000,25,007,"Dukes County, MA",2014,9412,8674,738,7.800000
CN2500900000000,25,009,"Essex County, MA",2014,403201,379137,24064,6.000000
CN2501100000000,25,011,"Franklin County, MA",2014,39558,37477,2081,5.300000
CN2501300000000,25,013,"Hampden County, MA",2014,222549,205148,17401,7.800000
CN2501500000000,25,015,"Hampshire County, MA",2014,86287,81945,4342,5.000000
CN2501700000000,25,017,"Middlesex County, MA",2014,851640,812047,39593,4.600000
CN2501900000000,25,019,"Nantucket County/town, MA",2014,6846,6423,423,6.200000
CN2502100000000,25,021,"Norfolk County, MA",2014,367341,348995,18346,5.000000
CN2502300000000,25,023,"Plymouth County, MA",2014,266550,250467,16083,6.000000
CN2502500000000,25,025,"Suffolk County, MA",2014,411889,389822,22067,5.400000
CN2502700000000,25,027,"Worcester County, MA",2014,425404,399062,26342,6.200000
CN2600100000000,26,001,"Alcona County, MI",2014,3836,3435,401,10.500000
CN2600300000000,26,003,"Alger County, MI",2014,3315,2975,340,10.300000
CN2600500000000,26,005,"Allegan County, MI",2014,59466,56253,3213,5.400000
CN2600700000000,26,007,"Alpena County, MI",2014,13527,12460,1067,7.900000
CN2600900000000,26,009,"Antrim County, MI",2014,10080,9132,948,9.400000
CN2601100000000,26,011,"Arenac County, MI",2014,6453,5753,700,10.800000
CN2601300000000,26,013,"Baraga County, MI",2014,3494,3110,384,11.000000
CN2601500000000,26,015,"Barry County, MI",2014,30154,28539,1615,5.400000
CN2601700000000,26,017,"Bay County, MI",2014,53296,49488,3808,7.100000
CN2601900000000,26,019,"Benzie County, MI",2014,8735,7997,738,8.400000
CN2602100000000,26,021,"Berrien County, MI",2014,73339,68413,4926,6.700000
CN2602300000000,26,023,"Branch County, MI",2014,19265,18001,1264,6.600000
CN2602500000000,26,025,"Calhoun County, MI",2014,64096,60083,4013,6.300000
CN2602700000000,26,027,"Cass County, MI",2014,23982,22399,1583,6.600000
CN2602900000000,26,029,"Charlevoix County, MI",2014,13115,12061,1054,8.000000
CN2603100000000,26,031,"Cheboygan County, MI",2014,10685,9568,1117,10.500000
CN2603300000000,26,033,"Chippewa County, MI",2014,16868,15277,1591,9.400000
CN2603500000000,26,035,"Clare County, MI",2014,11891,10735,1156,9.700000
CN2603700000000,26,037,"Clinton County, MI",2014,39655,37675,1980,5.000000
CN2603900000000,26,039,"Crawford County, MI",2014,5371,4868,503,9.400000
CN2604100000000,26,041,"Delta County, MI",2014,17530,16078,1452,8.300000
CN2604300000000,26,043,"Dickinson County, MI",2014,12968,12106,862,6.600000
CN2604500000000,26,045,"Eaton County, MI",2014,56133,52953,3180,5.700000
CN2604700000000,26,047,"Emmet County, MI",2014,17960,16276,1684,9.400000
CN2604900000000,26,049,"Genesee County, MI",2014,184458,170159,14299,7.800000
CN2605100000000,26,051,"Gladwin County, MI",2014,10045,9124,921,9.200000
CN2605300000000,26,053,"Gogebic County, MI",2014,6750,6160,590,8.700000
CN2605500000000,26,055,"Grand Traverse County, MI",2014,47880,45049,2831,5.900000
CN2605700000000,26,057,"Gratiot County, MI",2014,18509,17195,1314,7.100000
CN2605900000000,26,059,"Hillsdale County, MI",2014,20452,19011,1441,7.000000
CN2606100000000,26,061,"Houghton County, MI",2014,16934,15671,1263,7.500000
CN2606300000000,26,063,"Huron County, MI",2014,16630,15491,1139,6.800000
CN2606500000000,26,065,"Ingham County, MI",2014,145366,136616,8750,6.000000
CN2606700000000,26,067,"Ionia County, MI",2014,29210,27432,1778,6.100000
CN2606900000000,26,069,"Iosco County, MI",2014,10353,9361,992,9.600000
CN2607100000000,26,071,"Iron County, MI",2014,5124,4676,448,8.700000
CN2607300000000,26,073,"Isabella County, MI",2014,35459,33389,2070,5.800000
CN2607500000000,26,075,"Jackson County, MI",2014,72918,68084,4834,6.600000
CN2607700000000,26,077,"Kalamazoo County, MI",2014,127445,120362,7083,5.600000
CN2607900000000,26,079,"Kalkaska County, MI",2014,7687,6968,719,9.400000
CN2608100000000,26,081,"Kent County, MI",2014,335617,319226,16391,4.900000
CN2608300000000,26,083,"Keweenaw County, MI",2014,977,872,105,10.700000
CN2608500000000,26,085,"Lake County, MI",2014,3613,3214,399,11.000000
CN2608700000000,26,087,"Lapeer County, MI",2014,39995,36051,3944,9.900000
CN2608900000000,26,089,"Leelanau County, MI",2014,10531,9833,698,6.600000
CN2609100000000,26,091,"Lenawee County, MI",2014,48161,45075,3086,6.400000
CN2609300000000,26,093,"Livingston County, MI",2014,94929,88565,6364,6.700000
CN2609500000000,26,095,"Luce County, MI",2014,2489,2279,210,8.400000
CN2609700000000,26,097,"Mackinac County, MI",2014,5290,4709,581,11.000000
CN2609900000000,26,099,"Macomb County, MI",2014,418288,384087,34201,8.200000
CN2610100000000,26,101,"Manistee County, MI",2014,10409,9542,867,8.300000
CN2610300000000,26,103,"Marquette County, MI",2014,33842,31494,2348,6.900000
CN2610500000000,26,105,"Mason County, MI",2014,14794,13709,1085,7.300000
CN2610700000000,26,107,"Mecosta County, MI",2014,18952,17468,1484,7.800000
CN2610900000000,26,109,"Menominee County, MI",2014,11770,10977,793,6.700000
CN2611100000000,26,111,"Midland County, MI",2014,41494,38993,2501,6.000000
CN2611300000000,26,113,"Missaukee County, MI",2014,7123,6571,552,7.700000
CN2611500000000,26,115,"Monroe County, MI",2014,75701,71071,4630,6.100000
CN2611700000000,26,117,"Montcalm County, MI",2014,28003,25921,2082,7.400000
CN2611900000000,26,119,"Montmorency County, MI",2014,3191,2785,406,12.700000
CN2612100000000,26,121,"Muskegon County, MI",2014,76809,71123,5686,7.400000
CN2612300000000,26,123,"Newaygo County, MI",2014,22505,20897,1608,7.100000
CN2612500000000,26,125,"Oakland County, MI",2014,627399,584634,42765,6.800000
CN2612700000000,26,127,"Oceana County, MI",2014,12905,11635,1270,9.800000
CN2612900000000,26,129,"Ogemaw County, MI",2014,8571,7738,833,9.700000
CN2613100000000,26,131,"Ontonagon County, MI",2014,2422,2152,270,11.100000
CN2613300000000,26,133,"Osceola County, MI",2014,10168,9303,865,8.500000
CN2613500000000,26,135,"Oscoda County, MI",2014,2927,2577,350,12.000000
CN2613700000000,26,137,"Otsego County, MI",2014,11184,10288,896,8.000000
CN2613900000000,26,139,"Ottawa County, MI",2014,148812,141774,7038,4.700000
CN2614100000000,26,141,"Presque Isle County, MI",2014,5418,4729,689,12.700000
CN2614300000000,26,143,"Roscommon County, MI",2014,7990,7088,902,11.300000
CN2614500000000,26,145,"Saginaw County, MI",2014,89280,82718,6562,7.300000
CN2614700000000,26,147,"St. Clair County, MI",2014,73900,66598,7302,9.900000
CN2614900000000,26,149,"St. Joseph County, MI",2014,29013,27356,1657,5.700000
CN2615100000000,26,151,"Sanilac County, MI",2014,19722,18067,1655,8.400000
CN2615300000000,26,153,"Schoolcraft County, MI",2014,3538,3155,383,10.800000
CN2615500000000,26,155,"Shiawassee County, MI",2014,33275,30807,2468,7.400000
CN2615700000000,26,157,"Tuscola County, MI",2014,25232,23096,2136,8.500000
CN2615900000000,26,159,"Van Buren County, MI",2014,35519,32733,2786,7.800000
CN2616100000000,26,161,"Washtenaw County, MI",2014,186775,177805,8970,4.800000
CN2616300000000,26,163,"Wayne County, MI",2014,766626,689763,76863,10.000000
CN2616500000000,26,165,"Wexford County, MI",2014,14694,13453,1241,8.400000
CN2700100000000,27,001,"Aitkin County, MN",2014,6787,6349,438,6.500000
CN2700300000000,27,003,"Anoka County, MN",2014,189696,182015,7681,4.000000
CN2700500000000,27,005,"Becker County, MN",2014,17969,17129,840,4.700000
CN2700700000000,27,007,"Beltrami County, MN",2014,23413,22191,1222,5.200000
CN2700900000000,27,009,"Benton County, MN",2014,21633,20558,1075,5.000000
CN2701100000000,27,011,"Big Stone County, MN",2014,2583,2470,113,4.400000
CN2701300000000,27,013,"Blue Earth County, MN",2014,38765,37446,1319,3.400000
CN2701500000000,27,015,"Brown County, MN",2014,14133,13495,638,4.500000
CN2701700000000,27,017,"Carlton County, MN",2014,17487,16581,906,5.200000
CN2701900000000,27,019,"Carver County, MN",2014,53852,51937,1915,3.600000
CN2702100000000,27,021,"Cass County, MN",2014,14029,13053,976,7.000000
CN2702300000000,27,023,"Chippewa County, MN",2014,6921,6615,306,4.400000
CN2702500000000,27,025,"Chisago County, MN",2014,28735,27410,1325,4.600000
CN2702700000000,27,027,"Clay County, MN",2014,35589,34411,1178,3.300000
CN2702900000000,27,029,"Clearwater County, MN",2014,4547,4077,470,10.300000
CN2703100000000,27,031,"Cook County, MN",2014,3074,2905,169,5.500000
CN2703300000000,27,033,"Cottonwood County, MN",2014,5610,5323,287,5.100000
CN2703500000000,27,035,"Crow Wing County, MN",2014,31410,29603,1807,5.800000
CN2703700000000,27,037,"Dakota County, MN",2014,231677,223120,8557,3.700000
CN2703900000000,27,039,"Dodge County, MN",2014,11301,10841,460,4.100000
CN2704100000000,27,041,"Douglas County, MN",2014,19962,19237,725,3.600000
CN2704300000000,27,043,"Faribault County, MN",2014,7420,7043,377,5.100000
CN2704500000000,27,045,"Fillmore County, MN",2014,11108,10630,478,4.300000
CN2704700000000,27,047,"Freeborn County, MN",2014,16300,15608,692,4.200000
CN2704900000000,27,049,"Goodhue County, MN",2014,26835,25802,1033,3.800000
CN2705100000000,27,051,"Grant County, MN",2014,3294,3132,162,4.900000
CN2705300000000,27,053,"Hennepin County, MN",2014,672114,647217,24897,3.700000
CN2705500000000,27,055,"Houston County, MN",2014,10458,10002,456,4.400000
CN2705700000000,27,057,"Hubbard County, MN",2014,9465,8870,595,6.300000
CN2705900000000,27,059,"Isanti County, MN",2014,20336,19326,1010,5.000000
CN2706100000000,27,061,"Itasca County, MN",2014,21995,20578,1417,6.400000
CN2706300000000,27,063,"Jackson County, MN",2014,6309,6051,258,4.100000
CN2706500000000,27,065,"Kanabec County, MN",2014,8858,8202,656,7.400000
CN2706700000000,27,067,"Kandiyohi County, MN",2014,23798,22808,990,4.200000
CN2706900000000,27,069,"Kittson County, MN",2014,2388,2273,115,4.800000
CN2707100000000,27,071,"Koochiching County, MN",2014,6409,5868,541,8.400000
CN2707300000000,27,073,"Lac qui Parle County, MN",2014,3638,3466,172,4.700000
CN2707500000000,27,075,"Lake County, MN",2014,5673,5418,255,4.500000
CN2707700000000,27,077,"Lake of the Woods County, MN",2014,2396,2284,112,4.700000
CN2707900000000,27,079,"Le Sueur County, MN",2014,15653,14831,822,5.300000
CN2708100000000,27,081,"Lincoln County, MN",2014,3303,3163,140,4.200000
CN2708300000000,27,083,"Lyon County, MN",2014,15331,14795,536,3.500000
CN2708500000000,27,085,"McLeod County, MN",2014,19808,18909,899,4.500000
CN2708700000000,27,087,"Mahnomen County, MN",2014,2356,2225,131,5.600000
CN2708900000000,27,089,"Marshall County, MN",2014,5621,5252,369,6.600000
CN2709100000000,27,091,"Martin County, MN",2014,10273,9798,475,4.600000
CN2709300000000,27,093,"Meeker County, MN",2014,12901,12322,579,4.500000
CN2709500000000,27,095,"Mille Lacs County, MN",2014,12790,11940,850,6.600000
CN2709700000000,27,097,"Morrison County, MN",2014,17364,16295,1069,6.200000
CN2709900000000,27,099,"Mower County, MN",2014,20328,19568,760,3.700000
CN2710100000000,27,101,"Murray County, MN",2014,4871,4638,233,4.800000
CN2710300000000,27,103,"Nicollet County, MN",2014,19800,19209,591,3.000000
CN2710500000000,27,105,"Nobles County, MN",2014,11220,10841,379,3.400000
CN2710700000000,27,107,"Norman County, MN",2014,3327,3164,163,4.900000
CN2710900000000,27,109,"Olmsted County, MN",2014,82905,80098,2807,3.400000
CN2711100000000,27,111,"Otter Tail County, MN",2014,30991,29613,1378,4.400000
CN2711300000000,27,113,"Pennington County, MN",2014,8955,8511,444,5.000000
CN2711500000000,27,115,"Pine County, MN",2014,14655,13769,886,6.000000
CN2711700000000,27,117,"Pipestone County, MN",2014,4795,4617,178,3.700000
CN2711900000000,27,119,"Polk County, MN",2014,17194,16424,770,4.500000
CN2712100000000,27,121,"Pope County, MN",2014,6121,5899,222,3.600000
CN2712300000000,27,123,"Ramsey County, MN",2014,277177,266235,10942,3.900000
CN2712500000000,27,125,"Red Lake County, MN",2014,2278,2149,129,5.700000
CN2712700000000,27,127,"Redwood County, MN",2014,8036,7688,348,4.300000
CN2712900000000,27,129,"Renville County, MN",2014,8239,7802,437,5.300000
CN2713100000000,27,131,"Rice County, MN",2014,35132,33713,1419,4.000000
CN2713300000000,27,133,"Rock County, MN",2014,5678,5537,141,2.500000
CN2713500000000,27,135,"Roseau County, MN",2014,8818,8501,317,3.600000
CN2713700000000,27,137,"St. Louis County, MN",2014,101800,96681,5119,5.000000
CN2713900000000,27,139,"Scott County, MN",2014,77622,74879,2743,3.500000
CN2714100000000,27,141,"Sherburne County, MN",2014,49186,47001,2185,4.400000
CN2714300000000,27,143,"Sibley County, MN",2014,8425,8049,376,4.500000
CN2714500000000,27,145,"Stearns County, MN",2014,87592,84083,3509,4.000000
CN2714700000000,27,147,"Steele County, MN",2014,21195,20404,791,3.700000
CN2714900000000,27,149,"Stevens County, MN",2014,5571,5395,176,3.200000
CN2715100000000,27,151,"Swift County, MN",2014,4862,4628,234,4.800000
CN2715300000000,27,153,"Todd County, MN",2014,12912,12324,588,4.600000
CN2715500000000,27,155,"Traverse County, MN",2014,1647,1570,77,4.700000
CN2715700000000,27,157,"Wabasha County, MN",2014,11826,11360,466,3.900000
CN2715900000000,27,159,"Wadena County, MN",2014,6158,5781,377,6.100000
CN2716100000000,27,161,"Waseca County, MN",2014,9668,9211,457,4.700000
CN2716300000000,27,163,"Washington County, MN",2014,136015,131173,4842,3.600000
CN2716500000000,27,165,"Watonwan County, MN",2014,6151,5850,301,4.900000
CN2716700000000,27,167,"Wilkin County, MN",2014,3599,3480,119,3.300000
CN2716900000000,27,169,"Winona County, MN",2014,29410,28338,1072,3.600000
CN2717100000000,27,171,"Wright County, MN",2014,71124,68190,2934,4.100000
CN2717300000000,27,173,"Yellow Medicine County, MN",2014,5455,5231,224,4.100000
CN2800100000000,28,001,"Adams County, MS",2014,11485,10507,978,8.500000
CN2800300000000,28,003,"Alcorn County, MS",2014,15044,14023,1021,6.800000
CN2800500000000,28,005,"Amite County, MS",2014,4478,4113,365,8.200000
CN2800700000000,28,007,"Attala County, MS",2014,7039,6384,655,9.300000
CN2800900000000,28,009,"Benton County, MS",2014,3049,2762,287,9.400000
CN2801100000000,28,011,"Bolivar County, MS",2014,13180,11853,1327,10.100000
CN2801300000000,28,013,"Calhoun County, MS",2014,6212,5716,496,8.000000
CN2801500000000,28,015,"Carroll County, MS",2014,3387,3068,319,9.400000
CN2801700000000,28,017,"Chickasaw County, MS",2014,7163,6429,734,10.200000
CN2801900000000,28,019,"Choctaw County, MS",2014,3500,3200,300,8.600000
CN2802100000000,28,021,"Claiborne County, MS",2014,3113,2647,466,15.000000
CN2802300000000,28,023,"Clarke County, MS",2014,6232,5655,577,9.300000
CN2802500000000,28,025,"Clay County, MS",2014,7977,6854,1123,14.100000
CN2802700000000,28,027,"Coahoma County, MS",2014,9493,8312,1181,12.400000
CN2802900000000,28,029,"Copiah County, MS",2014,11138,10139,999,9.000000
CN2803100000000,28,031,"Covington County, MS",2014,7757,7241,516,6.700000
CN2803300000000,28,033,"DeSoto County, MS",2014,79242,74994,4248,5.400000
CN2803500000000,28,035,"Forrest County, MS",2014,32467,30036,2431,7.500000
CN2803700000000,28,037,"Franklin County, MS",2014,2868,2625,243,8.500000
CN2803900000000,28,039,"George County, MS",2014,8904,8157,747,8.400000
CN2804100000000,28,041,"Greene County, MS",2014,4394,3993,401,9.100000
CN2804300000000,28,043,"Grenada County, MS",2014,9152,8471,681,7.400000
CN2804500000000,28,045,"Hancock County, MS",2014,18330,16970,1360,7.400000
CN2804700000000,28,047,"Harrison County, MS",2014,83826,77963,5863,7.000000
CN2804900000000,28,049,"Hinds County, MS",2014,107895,99950,7945,7.400000
CN2805100000000,28,051,"Holmes County, MS",2014,6140,5167,973,15.800000
CN2805300000000,28,053,"Humphreys County, MS",2014,2576,2137,439,17.000000
CN2805500000000,28,055,"Issaquena County, MS",2014,425,347,78,18.400000
CN2805700000000,28,057,"Itawamba County, MS",2014,9764,9039,725,7.400000
CN2805900000000,28,059,"Jackson County, MS",2014,58908,54048,4860,8.300000
CN2806100000000,28,061,"Jasper County, MS",2014,6283,5734,549,8.700000
CN2806300000000,28,063,"Jefferson County, MS",2014,2389,1993,396,16.600000
CN2806500000000,28,065,"Jefferson Davis County, MS",2014,4075,3643,432,10.600000
CN2806700000000,28,067,"Jones County, MS",2014,26472,24813,1659,6.300000
CN2806900000000,28,069,"Kemper County, MS",2014,3765,3261,504,13.400000
CN2807100000000,28,071,"Lafayette County, MS",2014,22982,21557,1425,6.200000
CN2807300000000,28,073,"Lamar County, MS",2014,27073,25666,1407,5.200000
CN2807500000000,28,075,"Lauderdale County, MS",2014,32383,29836,2547,7.900000
CN2807700000000,28,077,"Lawrence County, MS",2014,4506,4114,392,8.700000
CN2807900000000,28,079,"Leake County, MS",2014,7770,7198,572,7.400000
CN2808100000000,28,081,"Lee County, MS",2014,38580,35627,2953,7.700000
CN2808300000000,28,083,"Leflore County, MS",2014,10490,9094,1396,13.300000
CN2808500000000,28,085,"Lincoln County, MS",2014,13623,12697,926,6.800000
CN2808700000000,28,087,"Lowndes County, MS",2014,25097,22751,2346,9.300000
CN2808900000000,28,089,"Madison County, MS",2014,48843,46186,2657,5.400000
CN2809100000000,28,091,"Marion County, MS",2014,9834,8978,856,8.700000
CN2809300000000,28,093,"Marshall County, MS",2014,14350,13075,1275,8.900000
CN2809500000000,28,095,"Monroe County, MS",2014,15318,13701,1617,10.600000
CN2809700000000,28,097,"Montgomery County, MS",2014,4168,3764,404,9.700000
CN2809900000000,28,099,"Neshoba County, MS",2014,10700,9971,729,6.800000
CN2810100000000,28,101,"Newton County, MS",2014,8638,8056,582,6.700000
CN2810300000000,28,103,"Noxubee County, MS",2014,4003,3467,536,13.400000
CN2810500000000,28,105,"Oktibbeha County, MS",2014,21685,20061,1624,7.500000
CN2810700000000,28,107,"Panola County, MS",2014,13343,11873,1470,11.000000
CN2810900000000,28,109,"Pearl River County, MS",2014,22105,20589,1516,6.900000
CN2811100000000,28,111,"Perry County, MS",2014,4156,3775,381,9.200000
CN2811300000000,28,113,"Pike County, MS",2014,14327,13109,1218,8.500000
CN2811500000000,28,115,"Pontotoc County, MS",2014,13329,12393,936,7.000000
CN2811700000000,28,117,"Prentiss County, MS",2014,10765,9919,846,7.900000
CN2811900000000,28,119,"Quitman County, MS",2014,2740,2369,371,13.500000
CN2812100000000,28,121,"Rankin County, MS",2014,69830,66561,3269,4.700000
CN2812300000000,28,123,"Scott County, MS",2014,12536,11839,697,5.600000
CN2812500000000,28,125,"Sharkey County, MS",2014,1776,1569,207,11.700000
CN2812700000000,28,127,"Simpson County, MS",2014,10698,10005,693,6.500000
CN2812900000000,28,129,"Smith County, MS",2014,6700,6297,403,6.000000
CN2813100000000,28,131,"Stone County, MS",2014,6266,5728,538,8.600000
CN2813300000000,28,133,"Sunflower County, MS",2014,8621,7471,1150,13.300000
CN2813500000000,28,135,"Tallahatchie County, MS",2014,5824,5256,568,9.800000
CN2813700000000,28,137,"Tate County, MS",2014,11758,10727,1031,8.800000
CN2813900000000,28,139,"Tippah County, MS",2014,8641,7903,738,8.500000
CN2814100000000,28,141,"Tishomingo County, MS",2014,7522,6928,594,7.900000
CN2814300000000,28,143,"Tunica County, MS",2014,4721,4139,582,12.300000
CN2814500000000,28,145,"Union County, MS",2014,12768,11952,816,6.400000
CN2814700000000,28,147,"Walthall County, MS",2014,5109,4614,495,9.700000
CN2814900000000,28,149,"Warren County, MS",2014,20674,19009,1665,8.100000
CN2815100000000,28,151,"Washington County, MS",2014,18281,15835,2446,13.400000
CN2815300000000,28,153,"Wayne County, MS",2014,7634,6933,701,9.200000
CN2815500000000,28,155,"Webster County, MS",2014,3919,3557,362,9.200000
CN2815700000000,28,157,"Wilkinson County, MS",2014,2801,2476,325,11.600000
CN2815900000000,28,159,"Winston County, MS",2014,7109,6352,757,10.600000
CN2816100000000,28,161,"Yalobusha County, MS",2014,4923,4441,482,9.800000
CN2816300000000,28,163,"Yazoo County, MS",2014,9275,8305,970,10.500000
CN2900100000000,29,001,"Adair County, MO",2014,11094,10412,682,6.100000
CN2900300000000,29,003,"Andrew County, MO",2014,9990,9483,507,5.100000
CN2900500000000,29,005,"Atchison County, MO",2014,2897,2739,158,5.500000
CN2900700000000,29,007,"Audrain County, MO",2014,11249,10625,624,5.500000
CN2900900000000,29,009,"Barry County, MO",2014,14854,13949,905,6.100000
CN2901100000000,29,011,"Barton County, MO",2014,5556,5202,354,6.400000
CN2901300000000,29,013,"Bates County, MO",2014,8156,7584,572,7.000000
CN2901500000000,29,015,"Benton County, MO",2014,7224,6675,549,7.600000
CN2901700000000,29,017,"Bollinger County, MO",2014,5755,5369,386,6.700000
CN2901900000000,29,019,"Boone County, MO",2014,98362,94304,4058,4.100000
CN2902100000000,29,021,"Buchanan County, MO",2014,46820,44184,2636,5.600000
CN2902300000000,29,023,"Butler County, MO",2014,19226,17900,1326,6.900000
CN2902500000000,29,025,"Caldwell County, MO",2014,4410,4165,245,5.600000
CN2902700000000,29,027,"Callaway County, MO",2014,21734,20517,1217,5.600000
CN2902900000000,29,029,"Camden County, MO",2014,18922,17403,1519,8.000000
CN2903100000000,29,031,"Cape Girardeau County, MO",2014,40812,38589,2223,5.400000
CN2903300000000,29,033,"Carroll County, MO",2014,4771,4431,340,7.100000
CN2903500000000,29,035,"Carter County, MO",2014,2575,2350,225,8.700000
CN2903700000000,29,037,"Cass County, MO",2014,53200,50178,3022,5.700000
CN2903900000000,29,039,"Cedar County, MO",2014,5900,5529,371,6.300000
CN2904100000000,29,041,"Chariton County, MO",2014,3845,3622,223,5.800000
CN2904300000000,29,043,"Christian County, MO",2014,42077,40014,2063,4.900000
CN2904500000000,29,045,"Clark County, MO",2014,3443,3208,235,6.800000
CN2904700000000,29,047,"Clay County, MO",2014,128955,121962,6993,5.400000
CN2904900000000,29,049,"Clinton County, MO",2014,10935,10296,639,5.800000
CN2905100000000,29,051,"Cole County, MO",2014,39984,37986,1998,5.000000
CN2905300000000,29,053,"Cooper County, MO",2014,7719,7264,455,5.900000
CN2905500000000,29,055,"Crawford County, MO",2014,10995,10144,851,7.700000
CN2905700000000,29,057,"Dade County, MO",2014,3516,3307,209,5.900000
CN2905900000000,29,059,"Dallas County, MO",2014,7096,6570,526,7.400000
CN2906100000000,29,061,"Daviess County, MO",2014,4060,3824,236,5.800000
CN2906300000000,29,063,"DeKalb County, MO",2014,5080,4808,272,5.400000
CN2906500000000,29,065,"Dent County, MO",2014,6320,5901,419,6.600000
CN2906700000000,29,067,"Douglas County, MO",2014,5034,4657,377,7.500000
CN2906900000000,29,069,"Dunklin County, MO",2014,13190,12036,1154,8.700000
CN2907100000000,29,071,"Franklin County, MO",2014,52131,48769,3362,6.400000
CN2907300000000,29,073,"Gasconade County, MO",2014,7657,7251,406,5.300000
CN2907500000000,29,075,"Gentry County, MO",2014,3657,3451,206,5.600000
CN2907700000000,29,077,"Greene County, MO",2014,148077,140917,7160,4.800000
CN2907900000000,29,079,"Grundy County, MO",2014,4955,4690,265,5.300000
CN2908100000000,29,081,"Harrison County, MO",2014,4017,3759,258,6.400000
CN2908300000000,29,083,"Henry County, MO",2014,10145,9496,649,6.400000
CN2908500000000,29,085,"Hickory County, MO",2014,3736,3425,311,8.300000
CN2908700000000,29,087,"Holt County, MO",2014,2734,2600,134,4.900000
CN2908900000000,29,089,"Howard County, MO",2014,5032,4762,270,5.400000
CN2909100000000,29,091,"Howell County, MO",2014,16319,15175,1144,7.000000
CN2909300000000,29,093,"Iron County, MO",2014,3928,3555,373,9.500000
CN2909500000000,29,095,"Jackson County, MO",2014,359322,333863,25459,7.100000
CN2909700000000,29,097,"Jasper County, MO",2014,57895,54844,3051,5.300000
CN2909900000000,29,099,"Jefferson County, MO",2014,116120,108859,7261,6.300000
CN2910100000000,29,101,"Johnson County, MO",2014,23182,21717,1465,6.300000
CN2910300000000,29,103,"Knox County, MO",2014,2008,1917,91,4.500000
CN2910500000000,29,105,"Laclede County, MO",2014,15919,14640,1279,8.000000
CN2910700000000,29,107,"Lafayette County, MO",2014,17256,16239,1017,5.900000
CN2910900000000,29,109,"Lawrence County, MO",2014,17545,16517,1028,5.900000
CN2911100000000,29,111,"Lewis County, MO",2014,5173,4905,268,5.200000
CN2911300000000,29,113,"Lincoln County, MO",2014,26482,24760,1722,6.500000
CN2911500000000,29,115,"Linn County, MO",2014,5243,4825,418,8.000000
CN2911700000000,29,117,"Livingston County, MO",2014,7338,6973,365,5.000000
CN2911900000000,29,119,"McDonald County, MO",2014,10379,9786,593,5.700000
CN2912100000000,29,121,"Macon County, MO",2014,7519,7061,458,6.100000
CN2912300000000,29,123,"Madison County, MO",2014,5533,5163,370,6.700000
CN2912500000000,29,125,"Maries County, MO",2014,4013,3768,245,6.100000
CN2912700000000,29,127,"Marion County, MO",2014,14685,13877,808,5.500000
CN2912900000000,29,129,"Mercer County, MO",2014,1870,1776,94,5.000000
CN2913100000000,29,131,"Miller County, MO",2014,11690,10797,893,7.600000
CN2913300000000,29,133,"Mississippi County, MO",2014,6293,5832,461,7.300000
CN2913500000000,29,135,"Moniteau County, MO",2014,7379,6940,439,5.900000
CN2913700000000,29,137,"Monroe County, MO",2014,4197,3922,275,6.600000
CN2913900000000,29,139,"Montgomery County, MO",2014,5729,5386,343,6.000000
CN2914100000000,29,141,"Morgan County, MO",2014,8033,7351,682,8.500000
CN2914300000000,29,143,"New Madrid County, MO",2014,8474,7853,621,7.300000
CN2914500000000,29,145,"Newton County, MO",2014,28893,27355,1538,5.300000
CN2914700000000,29,147,"Nodaway County, MO",2014,11732,10973,759,6.500000
CN2914900000000,29,149,"Oregon County, MO",2014,4178,3869,309,7.400000
CN2915100000000,29,151,"Osage County, MO",2014,7262,6926,336,4.600000
CN2915300000000,29,153,"Ozark County, MO",2014,3663,3345,318,8.700000
CN2915500000000,29,155,"Pemiscot County, MO",2014,7124,6480,644,9.000000
CN2915700000000,29,157,"Perry County, MO",2014,10315,9758,557,5.400000
CN2915900000000,29,159,"Pettis County, MO",2014,20723,19459,1264,6.100000
CN2916100000000,29,161,"Phelps County, MO",2014,20239,18984,1255,6.200000
CN2916300000000,29,163,"Pike County, MO",2014,8197,7732,465,5.700000
CN2916500000000,29,165,"Platte County, MO",2014,53699,50953,2746,5.100000
CN2916700000000,29,167,"Polk County, MO",2014,14226,13338,888,6.200000
CN2916900000000,29,169,"Pulaski County, MO",2014,15336,14222,1114,7.300000
CN2917100000000,29,171,"Putnam County, MO",2014,2530,2405,125,4.900000
CN2917300000000,29,173,"Ralls County, MO",2014,5632,5335,297,5.300000
CN2917500000000,29,175,"Randolph County, MO",2014,10580,9861,719,6.800000
CN2917700000000,29,177,"Ray County, MO",2014,11286,10523,763,6.800000
CN2917900000000,29,179,"Reynolds County, MO",2014,2703,2481,222,8.200000
CN2918100000000,29,181,"Ripley County, MO",2014,5593,5147,446,8.000000
CN2918300000000,29,183,"St. Charles County, MO",2014,209612,199463,10149,4.800000
CN2918500000000,29,185,"St. Clair County, MO",2014,4023,3715,308,7.700000
CN2918600000000,29,186,"Ste. Genevieve County, MO",2014,9096,8500,596,6.600000
CN2918700000000,29,187,"St. Francois County, MO",2014,26452,24455,1997,7.500000
CN2918900000000,29,189,"St. Louis County, MO",2014,531068,500039,31029,5.800000
CN2919500000000,29,195,"Saline County, MO",2014,11308,10679,629,5.600000
CN2919700000000,29,197,"Schuyler County, MO",2014,1958,1821,137,7.000000
CN2919900000000,29,199,"Scotland County, MO",2014,2423,2307,116,4.800000
CN2920100000000,29,201,"Scott County, MO",2014,19971,18660,1311,6.600000
CN2920300000000,29,203,"Shannon County, MO",2014,3436,3114,322,9.400000
CN2920500000000,29,205,"Shelby County, MO",2014,3076,2890,186,6.000000
CN2920700000000,29,207,"Stoddard County, MO",2014,13158,12159,999,7.600000
CN2920900000000,29,209,"Stone County, MO",2014,13528,12248,1280,9.500000
CN2921100000000,29,211,"Sullivan County, MO",2014,2765,2584,181,6.500000
CN2921300000000,29,213,"Taney County, MO",2014,25687,23224,2463,9.600000
CN2921500000000,29,215,"Texas County, MO",2014,9459,8721,738,7.800000
CN2921700000000,29,217,"Vernon County, MO",2014,9856,9300,556,5.600000
CN2921900000000,29,219,"Warren County, MO",2014,17053,15995,1058,6.200000
CN2922100000000,29,221,"Washington County, MO",2014,10521,9625,896,8.500000
CN2922300000000,29,223,"Wayne County, MO",2014,5675,5260,415,7.300000
CN2922500000000,29,225,"Webster County, MO",2014,16295,15322,973,6.000000
CN2922700000000,29,227,"Worth County, MO",2014,1332,1280,52,3.900000
CN2922900000000,29,229,"Wright County, MO",2014,7669,7122,547,7.100000
CN2951000000000,29,510,"St. Louis city, MO",2014,161379,148984,12395,7.700000
CN3000100000000,30,001,"Beaverhead County, MT",2014,4903,4720,183,3.700000
CN3000300000000,30,003,"Big Horn County, MT",2014,5644,5079,565,10.000000
CN3000500000000,30,005,"Blaine County, MT",2014,2456,2313,143,5.800000
CN3000700000000,30,007,"Broadwater County, MT",2014,2532,2392,140,5.500000
CN3000900000000,30,009,"Carbon County, MT",2014,5446,5233,213,3.900000
CN3001100000000,30,011,"Carter County, MT",2014,685,662,23,3.400000
CN3001300000000,30,013,"Cascade County, MT",2014,38560,36881,1679,4.400000
CN3001500000000,30,015,"Chouteau County, MT",2014,2619,2534,85,3.200000
CN3001700000000,30,017,"Custer County, MT",2014,6614,6399,215,3.300000
CN3001900000000,30,019,"Daniels County, MT",2014,959,929,30,3.100000
CN3002100000000,30,021,"Dawson County, MT",2014,4898,4768,130,2.700000
CN3002300000000,30,023,"Deer Lodge County, MT",2014,5307,5069,238,4.500000
CN3002500000000,30,025,"Fallon County, MT",2014,2098,2058,40,1.900000
CN3002700000000,30,027,"Fergus County, MT",2014,5804,5551,253,4.400000
CN3002900000000,30,029,"Flathead County, MT",2014,44066,41206,2860,6.500000
CN3003100000000,30,031,"Gallatin County, MT",2014,57218,55225,1993,3.500000
CN3003300000000,30,033,"Garfield County, MT",2014,748,728,20,2.700000
CN3003500000000,30,035,"Glacier County, MT",2014,5965,5325,640,10.700000
CN3003700000000,30,037,"Golden Valley County, MT",2014,402,383,19,4.700000
CN3003900000000,30,039,"Granite County, MT",2014,1541,1433,108,7.000000
CN3004100000000,30,041,"Hill County, MT",2014,7902,7441,461,5.800000
CN3004300000000,30,043,"Jefferson County, MT",2014,5696,5434,262,4.600000
CN3004500000000,30,045,"Judith Basin County, MT",2014,975,933,42,4.300000
CN3004700000000,30,047,"Lake County, MT",2014,12640,11904,736,5.800000
CN3004900000000,30,049,"Lewis and Clark County, MT",2014,35495,34166,1329,3.700000
CN3005100000000,30,051,"Liberty County, MT",2014,988,957,31,3.100000
CN3005300000000,30,053,"Lincoln County, MT",2014,8041,7134,907,11.300000
CN3005500000000,30,055,"McCone County, MT",2014,1113,1086,27,2.400000
CN3005700000000,30,057,"Madison County, MT",2014,4253,4056,197,4.600000
CN3005900000000,30,059,"Meagher County, MT",2014,933,893,40,4.300000
CN3006100000000,30,061,"Mineral County, MT",2014,1770,1610,160,9.000000
CN3006300000000,30,063,"Missoula County, MT",2014,60284,57582,2702,4.500000
CN3006500000000,30,065,"Musselshell County, MT",2014,2405,2307,98,4.100000
CN3006700000000,30,067,"Park County, MT",2014,8114,7658,456,5.600000
CN3006900000000,30,069,"Petroleum County, MT",2014,298,286,12,4.000000
CN3007100000000,30,071,"Phillips County, MT",2014,2014,1906,108,5.400000
CN3007300000000,30,073,"Pondera County, MT",2014,2873,2731,142,4.900000
CN3007500000000,30,075,"Powder River County, MT",2014,1061,1027,34,3.200000
CN3007700000000,30,077,"Powell County, MT",2014,2967,2812,155,5.200000
CN3007900000000,30,079,"Prairie County, MT",2014,524,501,23,4.400000
CN3008100000000,30,081,"Ravalli County, MT",2014,18981,17802,1179,6.200000
CN3008300000000,30,083,"Richland County, MT",2014,7335,7159,176,2.400000
CN3008500000000,30,085,"Roosevelt County, MT",2014,4873,4616,257,5.300000
CN3008700000000,30,087,"Rosebud County, MT",2014,4204,3963,241,5.700000
CN3008900000000,30,089,"Sanders County, MT",2014,4694,4252,442,9.400000
CN3009100000000,30,091,"Sheridan County, MT",2014,2119,2062,57,2.700000
CN3009300000000,30,093,"Silver Bow County, MT",2014,17134,16280,854,5.000000
CN3009500000000,30,095,"Stillwater County, MT",2014,5058,4866,192,3.800000
CN3009700000000,30,097,"Sweet Grass County, MT",2014,1805,1741,64,3.500000
CN3009900000000,30,099,"Teton County, MT",2014,2922,2812,110,3.800000
CN3010100000000,30,101,"Toole County, MT",2014,2375,2303,72,3.000000
CN3010300000000,30,103,"Treasure County, MT",2014,353,338,15,4.200000
CN3010500000000,30,105,"Valley County, MT",2014,4390,4255,135,3.100000
CN3010700000000,30,107,"Wheatland County, MT",2014,796,756,40,5.000000
CN3010900000000,30,109,"Wibaux County, MT",2014,553,536,17,3.100000
CN3011100000000,30,111,"Yellowstone County, MT",2014,80039,77041,2998,3.700000
CN3100100000000,31,001,"Adams County, NE",2014,16915,16346,569,3.400000
CN3100300000000,31,003,"Antelope County, NE",2014,3629,3530,99,2.700000
CN3100500000000,31,005,"Arthur County, NE",2014,218,206,12,5.500000
CN3100700000000,31,007,"Banner County, NE",2014,421,405,16,3.800000
CN3100900000000,31,009,"Blaine County, NE",2014,266,254,12,4.500000
CN3101100000000,31,011,"Boone County, NE",2014,3054,2974,80,2.600000
CN3101300000000,31,013,"Box Butte County, NE",2014,5861,5681,180,3.100000
CN3101500000000,31,015,"Boyd County, NE",2014,1113,1076,37,3.300000
CN3101700000000,31,017,"Brown County, NE",2014,1435,1386,49,3.400000
CN3101900000000,31,019,"Buffalo County, NE",2014,27662,26905,757,2.700000
CN3102100000000,31,021,"Burt County, NE",2014,3635,3477,158,4.300000
CN3102300000000,31,023,"Butler County, NE",2014,4854,4710,144,3.000000
CN3102500000000,31,025,"Cass County, NE",2014,13416,12909,507,3.800000
CN3102700000000,31,027,"Cedar County, NE",2014,4719,4605,114,2.400000
CN3102900000000,31,029,"Chase County, NE",2014,2368,2320,48,2.000000
CN3103100000000,31,031,"Cherry County, NE",2014,3456,3370,86,2.500000
CN3103300000000,31,033,"Cheyenne County, NE",2014,5825,5700,125,2.100000
CN3103500000000,31,035,"Clay County, NE",2014,3502,3386,116,3.300000
CN3103700000000,31,037,"Colfax County, NE",2014,5665,5498,167,2.900000
CN3103900000000,31,039,"Cuming County, NE",2014,4977,4843,134,2.700000
CN3104100000000,31,041,"Custer County, NE",2014,6195,6044,151,2.400000
CN3104300000000,31,043,"Dakota County, NE",2014,11448,10840,608,5.300000
CN3104500000000,31,045,"Dawes County, NE",2014,5336,5170,166,3.100000
CN3104700000000,31,047,"Dawson County, NE",2014,13372,12905,467,3.500000
CN3104900000000,31,049,"Deuel County, NE",2014,1093,1063,30,2.700000
CN3105100000000,31,051,"Dixon County, NE",2014,3147,3041,106,3.400000
CN3105300000000,31,053,"Dodge County, NE",2014,19362,18657,705,3.600000
CN3105500000000,31,055,"Douglas County, NE",2014,289144,278557,10587,3.700000
CN3105700000000,31,057,"Dundy County, NE",2014,1318,1288,30,2.300000
CN3105900000000,31,059,"Fillmore County, NE",2014,3291,3212,79,2.400000
CN3106100000000,31,061,"Franklin County, NE",2014,1584,1533,51,3.200000
CN3106300000000,31,063,"Frontier County, NE",2014,1561,1518,43,2.800000
CN3106500000000,31,065,"Furnas County, NE",2014,2730,2652,78,2.900000
CN3106700000000,31,067,"Gage County, NE",2014,11150,10681,469,4.200000
CN3106900000000,31,069,"Garden County, NE",2014,1190,1155,35,2.900000
CN3107100000000,31,071,"Garfield County, NE",2014,1216,1184,32,2.600000
CN3107300000000,31,073,"Gosper County, NE",2014,1145,1111,34,3.000000
CN3107500000000,31,075,"Grant County, NE",2014,416,405,11,2.600000
CN3107700000000,31,077,"Greeley County, NE",2014,1290,1249,41,3.200000
CN3107900000000,31,079,"Hall County, NE",2014,32722,31466,1256,3.800000
CN3108100000000,31,081,"Hamilton County, NE",2014,4852,4709,143,2.900000
CN3108300000000,31,083,"Harlan County, NE",2014,1832,1783,49,2.700000
CN3108500000000,31,085,"Hayes County, NE",2014,623,605,18,2.900000
CN3108700000000,31,087,"Hitchcock County, NE",2014,1351,1303,48,3.600000
CN3108900000000,31,089,"Holt County, NE",2014,5995,5834,161,2.700000
CN3109100000000,31,091,"Hooker County, NE",2014,432,414,18,4.200000
CN3109300000000,31,093,"Howard County, NE",2014,3434,3309,125,3.600000
CN3109500000000,31,095,"Jefferson County, NE",2014,4351,4217,134,3.100000
CN3109700000000,31,097,"Johnson County, NE",2014,2184,2099,85,3.900000
CN3109900000000,31,099,"Kearney County, NE",2014,3872,3777,95,2.500000
CN3110100000000,31,101,"Keith County, NE",2014,4708,4572,136,2.900000
CN3110300000000,31,103,"Keya Paha County, NE",2014,617,600,17,2.800000
CN3110500000000,31,105,"Kimball County, NE",2014,2251,2192,59,2.600000
CN3110700000000,31,107,"Knox County, NE",2014,4791,4640,151,3.200000
CN3110900000000,31,109,"Lancaster County, NE",2014,170250,165264,4986,2.900000
CN3111100000000,31,111,"Lincoln County, NE",2014,18969,18354,615,3.200000
CN3111300000000,31,113,"Logan County, NE",2014,503,487,16,3.200000
CN3111500000000,31,115,"Loup County, NE",2014,378,364,14,3.700000
CN3111700000000,31,117,"McPherson County, NE",2014,378,367,11,2.900000
CN3111900000000,31,119,"Madison County, NE",2014,19454,18878,576,3.000000
CN3112100000000,31,121,"Merrick County, NE",2014,4222,4065,157,3.700000
CN3112300000000,31,123,"Morrill County, NE",2014,2707,2626,81,3.000000
CN3112500000000,31,125,"Nance County, NE",2014,2090,2033,57,2.700000
CN3112700000000,31,127,"Nemaha County, NE",2014,3764,3613,151,4.000000
CN3112900000000,31,129,"Nuckolls County, NE",2014,2440,2370,70,2.900000
CN3113100000000,31,131,"Otoe County, NE",2014,8349,8031,318,3.800000
CN3113300000000,31,133,"Pawnee County, NE",2014,1669,1622,47,2.800000
CN3113500000000,31,135,"Perkins County, NE",2014,1861,1821,40,2.100000
CN3113700000000,31,137,"Phelps County, NE",2014,5087,4952,135,2.700000
CN3113900000000,31,139,"Pierce County, NE",2014,4258,4137,121,2.800000
CN3114100000000,31,141,"Platte County, NE",2014,17440,16921,519,3.000000
CN3114300000000,31,143,"Polk County, NE",2014,2990,2895,95,3.200000
CN3114500000000,31,145,"Red Willow County, NE",2014,6347,6182,165,2.600000
CN3114700000000,31,147,"Richardson County, NE",2014,4366,4187,179,4.100000
CN3114900000000,31,149,"Rock County, NE",2014,883,860,23,2.600000
CN3115100000000,31,151,"Saline County, NE",2014,7303,7046,257,3.500000
CN3115300000000,31,153,"Sarpy County, NE",2014,90144,87314,2830,3.100000
CN3115500000000,31,155,"Saunders County, NE",2014,11234,10845,389,3.500000
CN3115700000000,31,157,"Scotts Bluff County, NE",2014,18792,18092,700,3.700000
CN3115900000000,31,159,"Seward County, NE",2014,9053,8782,271,3.000000
CN3116100000000,31,161,"Sheridan County, NE",2014,2800,2715,85,3.000000
CN3116300000000,31,163,"Sherman County, NE",2014,1747,1689,58,3.300000
CN3116500000000,31,165,"Sioux County, NE",2014,800,778,22,2.800000
CN3116700000000,31,167,"Stanton County, NE",2014,3590,3489,101,2.800000
CN3116900000000,31,169,"Thayer County, NE",2014,3051,2971,80,2.600000
CN3117100000000,31,171,"Thomas County, NE",2014,428,413,15,3.500000
CN3117300000000,31,173,"Thurston County, NE",2014,3063,2859,204,6.700000
CN3117500000000,31,175,"Valley County, NE",2014,2133,2070,63,3.000000
CN3117700000000,31,177,"Washington County, NE",2014,11240,10878,362,3.200000
CN3117900000000,31,179,"Wayne County, NE",2014,5616,5457,159,2.800000
CN3118100000000,31,181,"Webster County, NE",2014,1750,1690,60,3.400000
CN3118300000000,31,183,"Wheeler County, NE",2014,523,508,15,2.900000
CN3118500000000,31,185,"York County, NE",2014,7498,7262,236,3.100000
CN3200100000000,32,001,"Churchill County, NV",2014,10761,9961,800,7.400000
CN3200300000000,32,003,"Clark County, NV",2014,1019653,940006,79647,7.800000
CN3200500000000,32,005,"Douglas County, NV",2014,22323,20565,1758,7.900000
CN3200700000000,32,007,"Elko County, NV",2014,28175,26631,1544,5.500000
CN3200900000000,32,009,"Esmeralda County, NV",2014,534,510,24,4.500000
CN3201100000000,32,011,"Eureka County, NV",2014,1071,1008,63,5.900000
CN3201300000000,32,013,"Humboldt County, NV",2014,8969,8419,550,6.100000
CN3201500000000,32,015,"Lander County, NV",2014,3360,3143,217,6.500000
CN3201700000000,32,017,"Lincoln County, NV",2014,1944,1793,151,7.800000
CN3201900000000,32,019,"Lyon County, NV",2014,22760,20458,2302,10.100000
CN3202100000000,32,021,"Mineral County, NV",2014,1671,1485,186,11.100000
CN3202300000000,32,023,"Nye County, NV",2014,16320,14770,1550,9.500000
CN3202700000000,32,027,"Pershing County, NV",2014,2591,2402,189,7.300000
CN3202900000000,32,029,"Storey County, NV",2014,1890,1720,170,9.000000
CN3203100000000,32,031,"Washoe County, NV",2014,222613,206059,16554,7.400000
CN3203300000000,32,033,"White Pine County, NV",2014,4897,4604,293,6.000000
CN3251000000000,32,510,"Carson City, NV",2014,25068,22940,2128,8.500000
CN3300100000000,33,001,"Belknap County, NH",2014,31788,30474,1314,4.100000
CN3300300000000,33,003,"Carroll County, NH",2014,24319,23285,1034,4.300000
CN3300500000000,33,005,"Cheshire County, NH",2014,41642,39929,1713,4.100000
CN3300700000000,33,007,"Coos County, NH",2014,15490,14588,902,5.800000
CN3300900000000,33,009,"Grafton County, NH",2014,48088,46361,1727,3.600000
CN3301100000000,33,011,"Hillsborough County, NH",2014,228666,218345,10321,4.500000
CN3301300000000,33,013,"Merrimack County, NH",2014,81156,78065,3091,3.800000
CN3301500000000,33,015,"Rockingham County, NH",2014,175766,167572,8194,4.700000
CN3301700000000,33,017,"Strafford County, NH",2014,70253,67442,2811,4.000000
CN3301900000000,33,019,"Sullivan County, NH",2014,24011,23159,852,3.500000
CN3400100000000,34,001,"Atlantic County, NJ",2014,133130,119313,13817,10.400000
CN3400300000000,34,003,"Bergen County, NJ",2014,479448,453688,25760,5.400000
CN3400500000000,34,005,"Burlington County, NJ",2014,232025,217354,14671,6.300000
CN3400700000000,34,007,"Camden County, NJ",2014,255560,236391,19169,7.500000
CN3400900000000,34,009,"Cape May County, NJ",2014,48961,43068,5893,12.000000
CN3401100000000,34,011,"Cumberland County, NJ",2014,67165,60536,6629,9.900000
CN3401300000000,34,013,"Essex County, NJ",2014,375861,346237,29624,7.900000
CN3401500000000,34,015,"Gloucester County, NJ",2014,148835,138254,10581,7.100000
CN3401700000000,34,017,"Hudson County, NJ",2014,357862,334604,23258,6.500000
CN3401900000000,34,019,"Hunterdon County, NJ",2014,66365,63213,3152,4.700000
CN3402100000000,34,021,"Mercer County, NJ",2014,194539,183413,11126,5.700000
CN3402300000000,34,023,"Middlesex County, NJ",2014,432112,406174,25938,6.000000
CN3402500000000,34,025,"Monmouth County, NJ",2014,328655,309086,19569,6.000000
CN3402700000000,34,027,"Morris County, NJ",2014,263878,250919,12959,4.900000
CN3402900000000,34,029,"Ocean County, NJ",2014,265294,246246,19048,7.200000
CN3403100000000,34,031,"Passaic County, NJ",2014,248437,228264,20173,8.100000
CN3403300000000,34,033,"Salem County, NJ",2014,31435,28843,2592,8.200000
CN3403500000000,34,035,"Somerset County, NJ",2014,173968,165075,8893,5.100000
CN3403700000000,34,037,"Sussex County, NJ",2014,78651,73737,4914,6.200000
CN3403900000000,34,039,"Union County, NJ",2014,279108,260112,18996,6.800000
CN3404100000000,34,041,"Warren County, NJ",2014,57425,53908,3517,6.100000
CN3500100000000,35,001,"Bernalillo County, NM",2014,318070,298629,19441,6.100000
CN3500300000000,35,003,"Catron County, NM",2014,1344,1248,96,7.100000
CN3500500000000,35,005,"Chaves County, NM",2014,26808,25195,1613,6.000000
CN3500600000000,35,006,"Cibola County, NM",2014,8972,8255,717,8.000000
CN3500700000000,35,007,"Colfax County, NM",2014,6280,5894,386,6.100000
CN3500900000000,35,009,"Curry County, NM",2014,21514,20450,1064,4.900000
CN3501100000000,35,011,"De Baca County, NM",2014,778,739,39,5.000000
CN3501300000000,35,013,"Dona Ana County, NM",2014,93212,86525,6687,7.200000
CN3501500000000,35,015,"Eddy County, NM",2014,29017,27771,1246,4.300000
CN3501700000000,35,017,"Grant County, NM",2014,12312,11496,816,6.600000
CN3501900000000,35,019,"Guadalupe County, NM",2014,1646,1521,125,7.600000
CN3502100000000,35,021,"Harding County, NM",2014,325,311,14,4.300000
CN3502300000000,35,023,"Hidalgo County, NM",2014,2049,1904,145,7.100000
CN3502500000000,35,025,"Lea County, NM",2014,30192,28904,1288,4.300000
CN3502700000000,35,027,"Lincoln County, NM",2014,9014,8486,528,5.900000
CN3502800000000,35,028,"Los Alamos County, NM",2014,8406,8064,342,4.100000
CN3502900000000,35,029,"Luna County, NM",2014,10623,8706,1917,18.000000
CN3503100000000,35,031,"McKinley County, NM",2014,23798,21458,2340,9.800000
CN3503300000000,35,033,"Mora County, NM",2014,2128,1891,237,11.100000
CN3503500000000,35,035,"Otero County, NM",2014,24818,23305,1513,6.100000
CN3503700000000,35,037,"Quay County, NM",2014,3456,3242,214,6.200000
CN3503900000000,35,039,"Rio Arriba County, NM",2014,16356,14995,1361,8.300000
CN3504100000000,35,041,"Roosevelt County, NM",2014,8094,7649,445,5.500000
CN3504300000000,35,043,"Sandoval County, NM",2014,59968,55711,4257,7.100000
CN3504500000000,35,045,"San Juan County, NM",2014,55116,51653,3463,6.300000
CN3504700000000,35,047,"San Miguel County, NM",2014,11214,10348,866,7.700000
CN3504900000000,35,049,"Santa Fe County, NM",2014,71510,67667,3843,5.400000
CN3505100000000,35,051,"Sierra County, NM",2014,3849,3511,338,8.800000
CN3505300000000,35,053,"Socorro County, NM",2014,6449,5987,462,7.200000
CN3505500000000,35,055,"Taos County, NM",2014,14752,13322,1430,9.700000
CN3505700000000,35,057,"Torrance County, NM",2014,5185,4690,495,9.500000
CN3505900000000,35,059,"Union County, NM",2014,1672,1587,85,5.100000
CN3506100000000,35,061,"Valencia County, NM",2014,29284,27036,2248,7.700000
CN3600100000000,36,001,"Albany County, NY",2014,157291,149585,7706,4.900000
CN3600300000000,36,003,"Allegany County, NY",2014,23344,21899,1445,6.200000
CN3600500000000,36,005,"Bronx County, NY",2014,606630,547151,59479,9.800000
CN3600700000000,36,007,"Broome County, NY",2014,88320,82494,5826,6.600000
CN3600900000000,36,009,"Cattaraugus County, NY",2014,36768,34239,2529,6.900000
CN3601100000000,36,011,"Cayuga County, NY",2014,37714,35460,2254,6.000000
CN3601300000000,36,013,"Chautauqua County, NY",2014,57727,53802,3925,6.800000
CN3601500000000,36,015,"Chemung County, NY",2014,38420,36013,2407,6.300000
CN3601700000000,36,017,"Chenango County, NY",2014,23306,21872,1434,6.200000
CN3601900000000,36,019,"Clinton County, NY",2014,36049,33638,2411,6.700000
CN3602100000000,36,021,"Columbia County, NY",2014,31486,29999,1487,4.700000
CN3602300000000,36,023,"Cortland County, NY",2014,23764,22234,1530,6.400000
CN3602500000000,36,025,"Delaware County, NY",2014,20239,18927,1312,6.500000
CN3602700000000,36,027,"Dutchess County, NY",2014,142053,134483,7570,5.300000
CN3602900000000,36,029,"Erie County, NY",2014,448222,420943,27279,6.100000
CN3603100000000,36,031,"Essex County, NY",2014,17593,16381,1212,6.900000
CN3603300000000,36,033,"Franklin County, NY",2014,20618,19116,1502,7.300000
CN3603500000000,36,035,"Fulton County, NY",2014,23463,21670,1793,7.600000
CN3603700000000,36,037,"Genesee County, NY",2014,30085,28424,1661,5.500000
CN3603900000000,36,039,"Greene County, NY",2014,20823,19428,1395,6.700000
CN3604100000000,36,041,"Hamilton County, NY",2014,2443,2265,178,7.300000
CN3604300000000,36,043,"Herkimer County, NY",2014,29085,27121,1964,6.800000
CN3604500000000,36,045,"Jefferson County, NY",2014,46699,43130,3569,7.600000
CN3604700000000,36,047,"Kings County, NY",2014,1222973,1128931,94042,7.700000
CN3604900000000,36,049,"Lewis County, NY",2014,11890,10960,930,7.800000
CN3605100000000,36,051,"Livingston County, NY",2014,31039,29245,1794,5.800000
CN3605300000000,36,053,"Madison County, NY",2014,33428,31285,2143,6.400000
CN3605500000000,36,055,"Monroe County, NY",2014,364745,343666,21079,5.800000
CN3605700000000,36,057,"Montgomery County, NY",2014,22242,20581,1661,7.500000
CN3605900000000,36,059,"Nassau County, NY",2014,684861,652211,32650,4.800000
CN3606100000000,36,061,"New York County, NY",2014,915344,859957,55387,6.100000
CN3606300000000,36,063,"Niagara County, NY",2014,102089,94994,7095,6.900000
CN3606500000000,36,065,"Oneida County, NY",2014,103635,97316,6319,6.100000
CN3606700000000,36,067,"Onondaga County, NY",2014,224744,212234,12510,5.600000
CN3606900000000,36,069,"Ontario County, NY",2014,54551,51686,2865,5.300000
CN3607100000000,36,071,"Orange County, NY",2014,175742,166109,9633,5.500000
CN3607300000000,36,073,"Orleans County, NY",2014,18165,16781,1384,7.600000
CN3607500000000,36,075,"Oswego County, NY",2014,55142,50713,4429,8.000000
CN3607700000000,36,077,"Otsego County, NY",2014,30248,28528,1720,5.700000
CN3607900000000,36,079,"Putnam County, NY",2014,50203,47752,2451,4.900000
CN3608100000000,36,081,"Queens County, NY",2014,1157675,1083808,73867,6.400000
CN3608300000000,36,083,"Rensselaer County, NY",2014,81533,77177,4356,5.300000
CN3608500000000,36,085,"Richmond County, NY",2014,222974,206826,16148,7.200000
CN3608700000000,36,087,"Rockland County, NY",2014,148428,140828,7600,5.100000
CN3608900000000,36,089,"St. Lawrence County, NY",2014,47230,43582,3648,7.700000
CN3609100000000,36,091,"Saratoga County, NY",2014,115554,110183,5371,4.600000
CN3609300000000,36,093,"Schenectady County, NY",2014,76221,72123,4098,5.400000
CN3609500000000,36,095,"Schoharie County, NY",2014,14921,13929,992,6.600000
CN3609700000000,36,097,"Schuyler County, NY",2014,8578,7984,594,6.900000
CN3609900000000,36,099,"Seneca County, NY",2014,15570,14690,880,5.700000
CN3610100000000,36,101,"Steuben County, NY",2014,44267,41203,3064,6.900000
CN3610300000000,36,103,"Suffolk County, NY",2014,766711,725918,40793,5.300000
CN3610500000000,36,105,"Sullivan County, NY",2014,33318,31093,2225,6.700000
CN3610700000000,36,107,"Tioga County, NY",2014,24033,22567,1466,6.100000
CN3610900000000,36,109,"Tompkins County, NY",2014,54643,52281,2362,4.300000
CN3611100000000,36,111,"Ulster County, NY",2014,88232,83136,5096,5.800000
CN3611300000000,36,113,"Warren County, NY",2014,32244,30146,2098,6.500000
CN3611500000000,36,115,"Washington County, NY",2014,28705,26971,1734,6.000000
CN3611700000000,36,117,"Wayne County, NY",2014,44652,41904,2748,6.200000
CN3611900000000,36,119,"Westchester County, NY",2014,470316,446219,24097,5.100000
CN3612100000000,36,121,"Wyoming County, NY",2014,18411,17212,1199,6.500000
CN3612300000000,36,123,"Yates County, NY",2014,11673,11022,651,5.600000
CN3700100000000,37,001,"Alamance County, NC",2014,76272,71999,4273,5.600000
CN3700300000000,37,003,"Alexander County, NC",2014,17155,16204,951,5.500000
CN3700500000000,37,005,"Alleghany County, NC",2014,4346,4053,293,6.700000
CN3700700000000,37,007,"Anson County, NC",2014,10864,10104,760,7.000000
CN3700900000000,37,009,"Ashe County, NC",2014,12310,11477,833,6.800000
CN3701100000000,37,011,"Avery County, NC",2014,7606,7123,483,6.400000
CN3701300000000,37,013,"Beaufort County, NC",2014,19864,18439,1425,7.200000
CN3701500000000,37,015,"Bertie County, NC",2014,8436,7777,659,7.800000
CN3701700000000,37,017,"Bladen County, NC",2014,14229,12923,1306,9.200000
CN3701900000000,37,019,"Brunswick County, NC",2014,47307,43735,3572,7.600000
CN3702100000000,37,021,"Buncombe County, NC",2014,127155,121350,5805,4.600000
CN3702300000000,37,023,"Burke County, NC",2014,39324,36892,2432,6.200000
CN3702500000000,37,025,"Cabarrus County, NC",2014,92661,87430,5231,5.600000
CN3702700000000,37,027,"Caldwell County, NC",2014,35472,32967,2505,7.100000
CN3702900000000,37,029,"Camden County, NC",2014,4441,4175,266,6.000000
CN3703100000000,37,031,"Carteret County, NC",2014,30894,29048,1846,6.000000
CN3703300000000,37,033,"Caswell County, NC",2014,9560,8894,666,7.000000
CN3703500000000,37,035,"Catawba County, NC",2014,74388,69705,4683,6.300000
CN3703700000000,37,037,"Chatham County, NC",2014,31582,30101,1481,4.700000
CN3703900000000,37,039,"Cherokee County, NC",2014,10957,10188,769,7.000000
CN3704100000000,37,041,"Chowan County, NC",2014,5649,5212,437,7.700000
CN3704300000000,37,043,"Clay County, NC",2014,4033,3775,258,6.400000
CN3704500000000,37,045,"Cleveland County, NC",2014,45480,42232,3248,7.100000
CN3704700000000,37,047,"Columbus County, NC",2014,22885,20978,1907,8.300000
CN3704900000000,37,049,"Craven County, NC",2014,40884,38100,2784,6.800000
CN3705100000000,37,051,"Cumberland County, NC",2014,126451,116619,9832,7.800000
CN3705300000000,37,053,"Currituck County, NC",2014,12289,11543,746,6.100000
CN3705500000000,37,055,"Dare County, NC",2014,19822,18199,1623,8.200000
CN3705700000000,37,057,"Davidson County, NC",2014,77923,73120,4803,6.200000
CN3705900000000,37,059,"Davie County, NC",2014,19684,18571,1113,5.700000
CN3706100000000,37,061,"Duplin County, NC",2014,26417,24756,1661,6.300000
CN3706300000000,37,063,"Durham County, NC",2014,150959,143422,7537,5.000000
CN3706500000000,37,065,"Edgecombe County, NC",2014,23063,20727,2336,10.100000
CN3706700000000,37,067,"Forsyth County, NC",2014,174969,164722,10247,5.900000
CN3706900000000,37,069,"Franklin County, NC",2014,28312,26569,1743,6.200000
CN3707100000000,37,071,"Gaston County, NC",2014,100681,94124,6557,6.500000
CN3707300000000,37,073,"Gates County, NC",2014,5188,4883,305,5.900000
CN3707500000000,37,075,"Graham County, NC",2014,3347,2916,431,12.900000
CN3707700000000,37,077,"Granville County, NC",2014,27965,26432,1533,5.500000
CN3707900000000,37,079,"Greene County, NC",2014,9363,8779,584,6.200000
CN3708100000000,37,081,"Guilford County, NC",2014,250327,234312,16015,6.400000
CN3708300000000,37,083,"Halifax County, NC",2014,21069,19058,2011,9.500000
CN3708500000000,37,085,"Harnett County, NC",2014,48877,45357,3520,7.200000
CN3708700000000,37,087,"Haywood County, NC",2014,27238,25727,1511,5.500000
CN3708900000000,37,089,"Henderson County, NC",2014,48956,46587,2369,4.800000
CN3709100000000,37,091,"Hertford County, NC",2014,9328,8652,676,7.200000
CN3709300000000,37,093,"Hoke County, NC",2014,19117,17602,1515,7.900000
CN3709500000000,37,095,"Hyde County, NC",2014,2154,1962,192,8.900000
CN3709700000000,37,097,"Iredell County, NC",2014,79485,74670,4815,6.100000
CN3709900000000,37,099,"Jackson County, NC",2014,18125,16970,1155,6.400000
CN3710100000000,37,101,"Johnston County, NC",2014,85187,80538,4649,5.500000
CN3710300000000,37,103,"Jones County, NC",2014,4520,4232,288,6.400000
CN3710500000000,37,105,"Lee County, NC",2014,24749,22754,1995,8.100000
CN3710700000000,37,107,"Lenoir County, NC",2014,27673,25734,1939,7.000000
CN3710900000000,37,109,"Lincoln County, NC",2014,39881,37514,2367,5.900000
CN3711100000000,37,111,"McDowell County, NC",2014,20596,19293,1303,6.300000
CN3711300000000,37,113,"Macon County, NC",2014,14849,13884,965,6.500000
CN3711500000000,37,115,"Madison County, NC",2014,9366,8819,547,5.800000
CN3711700000000,37,117,"Martin County, NC",2014,9819,9067,752,7.700000
CN3711900000000,37,119,"Mecklenburg County, NC",2014,540956,509197,31759,5.900000
CN3712100000000,37,121,"Mitchell County, NC",2014,6488,6001,487,7.500000
CN3712300000000,37,123,"Montgomery County, NC",2014,11401,10674,727,6.400000
CN3712500000000,37,125,"Moore County, NC",2014,37883,35639,2244,5.900000
CN3712700000000,37,127,"Nash County, NC",2014,43775,40332,3443,7.900000
CN3712900000000,37,129,"New Hanover County, NC",2014,109507,103164,6343,5.800000
CN3713100000000,37,131,"Northampton County, NC",2014,7943,7316,627,7.900000
CN3713300000000,37,133,"Onslow County, NC",2014,63739,59970,3769,5.900000
CN3713500000000,37,135,"Orange County, NC",2014,73196,69942,3254,4.400000
CN3713700000000,37,137,"Pamlico County, NC",2014,5278,4933,345,6.500000
CN3713900000000,37,139,"Pasquotank County, NC",2014,17177,15807,1370,8.000000
CN3714100000000,37,141,"Pender County, NC",2014,24990,23268,1722,6.900000
CN3714300000000,37,143,"Perquimans County, NC",2014,5095,4709,386,7.600000
CN3714500000000,37,145,"Person County, NC",2014,18113,16771,1342,7.400000
CN3714700000000,37,147,"Pitt County, NC",2014,86461,81029,5432,6.300000
CN3714900000000,37,149,"Polk County, NC",2014,8349,7915,434,5.200000
CN3715100000000,37,151,"Randolph County, NC",2014,66378,62212,4166,6.300000
CN3715300000000,37,153,"Richmond County, NC",2014,16957,15476,1481,8.700000
CN3715500000000,37,155,"Robeson County, NC",2014,50686,46005,4681,9.200000
CN3715700000000,37,157,"Rockingham County, NC",2014,41128,38134,2994,7.300000
CN3715900000000,37,159,"Rowan County, NC",2014,62646,58466,4180,6.700000
CN3716100000000,37,161,"Rutherford County, NC",2014,25198,23076,2122,8.400000
CN3716300000000,37,163,"Sampson County, NC",2014,29411,27590,1821,6.200000
CN3716500000000,37,165,"Scotland County, NC",2014,11915,10518,1397,11.700000
CN3716700000000,37,167,"Stanly County, NC",2014,28308,26639,1669,5.900000
CN3716900000000,37,169,"Stokes County, NC",2014,21788,20528,1260,5.800000
CN3717100000000,37,171,"Surry County, NC",2014,32669,30686,1983,6.100000
CN3717300000000,37,173,"Swain County, NC",2014,6363,5799,564,8.900000
CN3717500000000,37,175,"Transylvania County, NC",2014,13239,12471,768,5.800000
CN3717700000000,37,177,"Tyrrell County, NC",2014,1529,1383,146,9.500000
CN3717900000000,37,179,"Union County, NC",2014,106780,101318,5462,5.100000
CN3718100000000,37,181,"Vance County, NC",2014,17897,16256,1641,9.200000
CN3718300000000,37,183,"Wake County, NC",2014,517101,492473,24628,4.800000
CN3718500000000,37,185,"Warren County, NC",2014,7225,6596,629,8.700000
CN3718700000000,37,187,"Washington County, NC",2014,5013,4540,473,9.400000
CN3718900000000,37,189,"Watauga County, NC",2014,26826,25449,1377,5.100000
CN3719100000000,37,191,"Wayne County, NC",2014,53587,50224,3363,6.300000
CN3719300000000,37,193,"Wilkes County, NC",2014,29274,27364,1910,6.500000
CN3719500000000,37,195,"Wilson County, NC",2014,37397,33928,3469,9.300000
CN3719700000000,37,197,"Yadkin County, NC",2014,17585,16629,956,5.400000
CN3719900000000,37,199,"Yancey County, NC",2014,7452,6961,491,6.600000
CN3800100000000,38,001,"Adams County, ND",2014,1108,1076,32,2.900000
CN3800300000000,38,003,"Barnes County, ND",2014,5585,5404,181,3.200000
CN3800500000000,38,005,"Benson County, ND",2014,2476,2308,168,6.800000
CN3800700000000,38,007,"Billings County, ND",2014,498,483,15,3.000000
CN3800900000000,38,009,"Bottineau County, ND",2014,3227,3109,118,3.700000
CN3801100000000,38,011,"Bowman County, ND",2014,1893,1858,35,1.800000
CN3801300000000,38,013,"Burke County, ND",2014,1277,1241,36,2.800000
CN3801500000000,38,015,"Burleigh County, ND",2014,47920,46718,1202,2.500000
CN3801700000000,38,017,"Cass County, ND",2014,93540,91208,2332,2.500000
CN3801900000000,38,019,"Cavalier County, ND",2014,1988,1926,62,3.100000
CN3802100000000,38,021,"Dickey County, ND",2014,2578,2522,56,2.200000
CN3802300000000,38,023,"Divide County, ND",2014,1815,1787,28,1.500000
CN3802500000000,38,025,"Dunn County, ND",2014,4325,4270,55,1.300000
CN3802700000000,38,027,"Eddy County, ND",2014,1265,1190,75,5.900000
CN3802900000000,38,029,"Emmons County, ND",2014,1553,1461,92,5.900000
CN3803100000000,38,031,"Foster County, ND",2014,1636,1584,52,3.200000
CN3803300000000,38,033,"Golden Valley County, ND",2014,962,941,21,2.200000
CN3803500000000,38,035,"Grand Forks County, ND",2014,37387,36318,1069,2.900000
CN3803700000000,38,037,"Grant County, ND",2014,1285,1247,38,3.000000
CN3803900000000,38,039,"Griggs County, ND",2014,1175,1146,29,2.500000
CN3804100000000,38,041,"Hettinger County, ND",2014,1485,1451,34,2.300000
CN3804300000000,38,043,"Kidder County, ND",2014,1227,1174,53,4.300000
CN3804500000000,38,045,"LaMoure County, ND",2014,2219,2161,58,2.600000
CN3804700000000,38,047,"Logan County, ND",2014,902,873,29,3.200000
CN3804900000000,38,049,"McHenry County, ND",2014,3186,3042,144,4.500000
CN3805100000000,38,051,"McIntosh County, ND",2014,1235,1196,39,3.200000
CN3805300000000,38,053,"McKenzie County, ND",2014,9130,8997,133,1.500000
CN3805500000000,38,055,"McLean County, ND",2014,4852,4648,204,4.200000
CN3805700000000,38,057,"Mercer County, ND",2014,4192,4022,170,4.100000
CN3805900000000,38,059,"Morton County, ND",2014,16032,15493,539,3.400000
CN3806100000000,38,061,"Mountrail County, ND",2014,9030,8912,118,1.300000
CN3806300000000,38,063,"Nelson County, ND",2014,1522,1462,60,3.900000
CN3806500000000,38,065,"Oliver County, ND",2014,919,862,57,6.200000
CN3806700000000,38,067,"Pembina County, ND",2014,3596,3385,211,5.900000
CN3806900000000,38,069,"Pierce County, ND",2014,1809,1729,80,4.400000
CN3807100000000,38,071,"Ramsey County, ND",2014,5734,5524,210,3.700000
CN3807300000000,38,073,"Ransom County, ND",2014,2695,2614,81,3.000000
CN3807500000000,38,075,"Renville County, ND",2014,1395,1357,38,2.700000
CN3807700000000,38,077,"Richland County, ND",2014,8556,8287,269,3.100000
CN3807900000000,38,079,"Rolette County, ND",2014,4857,4286,571,11.800000
CN3808100000000,38,081,"Sargent County, ND",2014,2164,2113,51,2.400000
CN3808300000000,38,083,"Sheridan County, ND",2014,664,626,38,5.700000
CN3808500000000,38,085,"Sioux County, ND",2014,1347,1283,64,4.800000
CN3808700000000,38,087,"Slope County, ND",2014,480,469,11,2.300000
CN3808900000000,38,089,"Stark County, ND",2014,21558,21207,351,1.600000
CN3809100000000,38,091,"Steele County, ND",2014,1000,976,24,2.400000
CN3809300000000,38,093,"Stutsman County, ND",2014,10577,10275,302,2.900000
CN3809500000000,38,095,"Towner County, ND",2014,1192,1146,46,3.900000
CN3809700000000,38,097,"Traill County, ND",2014,4448,4325,123,2.800000
CN3809900000000,38,099,"Walsh County, ND",2014,5577,5307,270,4.800000
CN3810100000000,38,101,"Ward County, ND",2014,34869,33927,942,2.700000
CN3810300000000,38,103,"Wells County, ND",2014,2118,2017,101,4.800000
CN3810500000000,38,105,"Williams County, ND",2014,32308,31924,384,1.200000
CN3900100000000,39,001,"Adams County, OH",2014,10450,9499,951,9.100000
CN3900300000000,39,003,"Allen County, OH",2014,48461,45688,2773,5.700000
CN3900500000000,39,005,"Ashland County, OH",2014,25599,24102,1497,5.800000
CN3900700000000,39,007,"Ashtabula County, OH",2014,45155,41976,3179,7.000000
CN3900900000000,39,009,"Athens County, OH",2014,27216,25357,1859,6.800000
CN3901100000000,39,011,"Auglaize County, OH",2014,24197,23168,1029,4.300000
CN3901300000000,39,013,"Belmont County, OH",2014,31752,29654,2098,6.600000
CN3901500000000,39,015,"Brown County, OH",2014,19899,18468,1431,7.200000
CN3901700000000,39,017,"Butler County, OH",2014,186764,176714,10050,5.400000
CN3901900000000,39,019,"Carroll County, OH",2014,13645,12828,817,6.000000
CN3902100000000,39,021,"Champaign County, OH",2014,19957,18964,993,5.000000
CN3902300000000,39,023,"Clark County, OH",2014,65345,61701,3644,5.600000
CN3902500000000,39,025,"Clermont County, OH",2014,102806,97335,5471,5.300000
CN3902700000000,39,027,"Clinton County, OH",2014,16870,15586,1284,7.600000
CN3902900000000,39,029,"Columbiana County, OH",2014,50048,46848,3200,6.400000
CN3903100000000,39,031,"Coshocton County, OH",2014,16166,14988,1178,7.300000
CN3903300000000,39,033,"Crawford County, OH",2014,19857,18563,1294,6.500000
CN3903500000000,39,035,"Cuyahoga County, OH",2014,624344,584423,39921,6.400000
CN3903700000000,39,037,"Darke County, OH",2014,26295,24932,1363,5.200000
CN3903900000000,39,039,"Defiance County, OH",2014,18964,17943,1021,5.400000
CN3904100000000,39,041,"Delaware County, OH",2014,99524,95536,3988,4.000000
CN3904300000000,39,043,"Erie County, OH",2014,37885,35524,2361,6.200000
CN3904500000000,39,045,"Fairfield County, OH",2014,74869,71092,3777,5.000000
CN3904700000000,39,047,"Fayette County, OH",2014,14201,13384,817,5.800000
CN3904900000000,39,049,"Franklin County, OH",2014,645990,615240,30750,4.800000
CN3905100000000,39,051,"Fulton County, OH",2014,22301,20997,1304,5.800000
CN3905300000000,39,053,"Gallia County, OH",2014,12415,11480,935,7.500000
CN3905500000000,39,055,"Geauga County, OH",2014,49400,46866,2534,5.100000
CN3905700000000,39,057,"Greene County, OH",2014,79466,75344,4122,5.200000
CN3905900000000,39,059,"Guernsey County, OH",2014,18865,17607,1258,6.700000
CN3906100000000,39,061,"Hamilton County, OH",2014,404116,382545,21571,5.300000
CN3906300000000,39,063,"Hancock County, OH",2014,40601,38812,1789,4.400000
CN3906500000000,39,065,"Hardin County, OH",2014,15172,14323,849,5.600000
CN3906700000000,39,067,"Harrison County, OH",2014,7380,6941,439,5.900000
CN3906900000000,39,069,"Henry County, OH",2014,13737,12872,865,6.300000
CN3907100000000,39,071,"Highland County, OH",2014,17263,15945,1318,7.600000
CN3907300000000,39,073,"Hocking County, OH",2014,13314,12479,835,6.300000
CN3907500000000,39,075,"Holmes County, OH",2014,19839,19062,777,3.900000
CN3907700000000,39,077,"Huron County, OH",2014,27872,25661,2211,7.900000
CN3907900000000,39,079,"Jackson County, OH",2014,13209,12074,1135,8.600000
CN3908100000000,39,081,"Jefferson County, OH",2014,29840,27453,2387,8.000000
CN3908300000000,39,083,"Knox County, OH",2014,31071,29450,1621,5.200000
CN3908500000000,39,085,"Lake County, OH",2014,126134,119012,7122,5.600000
CN3908700000000,39,087,"Lawrence County, OH",2014,25783,24100,1683,6.500000
CN3908900000000,39,089,"Licking County, OH",2014,87242,82779,4463,5.100000
CN3909100000000,39,091,"Logan County, OH",2014,23097,21959,1138,4.900000
CN3909300000000,39,093,"Lorain County, OH",2014,151304,141306,9998,6.600000
CN3909500000000,39,095,"Lucas County, OH",2014,209116,195878,13238,6.300000
CN3909700000000,39,097,"Madison County, OH",2014,20432,19476,956,4.700000
CN3909900000000,39,099,"Mahoning County, OH",2014,108098,100981,7117,6.600000
CN3910100000000,39,101,"Marion County, OH",2014,27876,26227,1649,5.900000
CN3910300000000,39,103,"Medina County, OH",2014,95308,90392,4916,5.200000
CN3910500000000,39,105,"Meigs County, OH",2014,9138,8319,819,9.000000
CN3910700000000,39,107,"Mercer County, OH",2014,22654,21803,851,3.800000
CN3910900000000,39,109,"Miami County, OH",2014,51844,49085,2759,5.300000
CN3911100000000,39,111,"Monroe County, OH",2014,5964,5318,646,10.800000
CN3911300000000,39,113,"Montgomery County, OH",2014,250307,235201,15106,6.000000
CN3911500000000,39,115,"Morgan County, OH",2014,6691,6172,519,7.800000
CN3911700000000,39,117,"Morrow County, OH",2014,16948,15971,977,5.800000
CN3911900000000,39,119,"Muskingum County, OH",2014,39208,36454,2754,7.000000
CN3912100000000,39,121,"Noble County, OH",2014,5085,4699,386,7.600000
CN3912300000000,39,123,"Ottawa County, OH",2014,21775,20154,1621,7.400000
CN3912500000000,39,125,"Paulding County, OH",2014,9097,8610,487,5.400000
CN3912700000000,39,127,"Perry County, OH",2014,16087,14936,1151,7.200000
CN3912900000000,39,129,"Pickaway County, OH",2014,25879,24441,1438,5.600000
CN3913100000000,39,131,"Pike County, OH",2014,10448,9508,940,9.000000
CN3913300000000,39,133,"Portage County, OH",2014,87776,82669,5107,5.800000
CN3913500000000,39,135,"Preble County, OH",2014,21283,20086,1197,5.600000
CN3913700000000,39,137,"Putnam County, OH",2014,18680,17841,839,4.500000
CN3913900000000,39,139,"Richland County, OH",2014,54719,51216,3503,6.400000
CN3914100000000,39,141,"Ross County, OH",2014,33661,31531,2130,6.300000
CN3914300000000,39,143,"Sandusky County, OH",2014,31203,29446,1757,5.600000
CN3914500000000,39,145,"Scioto County, OH",2014,29928,27336,2592,8.700000
CN3914700000000,39,147,"Seneca County, OH",2014,27289,25759,1530,5.600000
CN3914900000000,39,149,"Shelby County, OH",2014,23709,22518,1191,5.000000
CN3915100000000,39,151,"Stark County, OH",2014,188619,177868,10751,5.700000
CN3915300000000,39,153,"Summit County, OH",2014,271591,255872,15719,5.800000
CN3915500000000,39,155,"Trumbull County, OH",2014,92919,86387,6532,7.000000
CN3915700000000,39,157,"Tuscarawas County, OH",2014,45247,42787,2460,5.400000
CN3915900000000,39,159,"Union County, OH",2014,26913,25743,1170,4.300000
CN3916100000000,39,161,"Van Wert County, OH",2014,14429,13732,697,4.800000
CN3916300000000,39,163,"Vinton County, OH",2014,5543,5106,437,7.900000
CN3916500000000,39,165,"Warren County, OH",2014,110718,105358,5360,4.800000
CN3916700000000,39,167,"Washington County, OH",2014,28195,26445,1750,6.200000
CN3916900000000,39,169,"Wayne County, OH",2014,59250,56534,2716,4.600000
CN3917100000000,39,171,"Williams County, OH",2014,18779,17766,1013,5.400000
CN3917300000000,39,173,"Wood County, OH",2014,68919,65363,3556,5.200000
CN3917500000000,39,175,"Wyandot County, OH",2014,12473,11933,540,4.300000
CN4000100000000,40,001,"Adair County, OK",2014,8052,7439,613,7.600000
CN4000300000000,40,003,"Alfalfa County, OK",2014,3046,2969,77,2.500000
CN4000500000000,40,005,"Atoka County, OK",2014,4776,4484,292,6.100000
CN4000700000000,40,007,"Beaver County, OK",2014,3136,3050,86,2.700000
CN4000900000000,40,009,"Beckham County, OK",2014,12588,12230,358,2.800000
CN4001100000000,40,011,"Blaine County, OK",2014,4478,4323,155,3.500000
CN4001300000000,40,013,"Bryan County, OK",2014,17710,16847,863,4.900000
CN4001500000000,40,015,"Caddo County, OK",2014,10979,10377,602,5.500000
CN4001700000000,40,017,"Canadian County, OK",2014,64407,62110,2297,3.600000
CN4001900000000,40,019,"Carter County, OK",2014,21761,20787,974,4.500000
CN4002100000000,40,021,"Cherokee County, OK",2014,18297,17207,1090,6.000000
CN4002300000000,40,023,"Choctaw County, OK",2014,5723,5258,465,8.100000
CN4002500000000,40,025,"Cimarron County, OK",2014,1277,1240,37,2.900000
CN4002700000000,40,027,"Cleveland County, OK",2014,135994,131024,4970,3.700000
CN4002900000000,40,029,"Coal County, OK",2014,2281,2125,156,6.800000
CN4003100000000,40,031,"Comanche County, OK",2014,48746,46424,2322,4.800000
CN4003300000000,40,033,"Cotton County, OK",2014,2821,2691,130,4.600000
CN4003500000000,40,035,"Craig County, OK",2014,5999,5664,335,5.600000
CN4003700000000,40,037,"Creek County, OK",2014,30954,29411,1543,5.000000
CN4003900000000,40,039,"Custer County, OK",2014,15823,15331,492,3.100000
CN4004100000000,40,041,"Delaware County, OK",2014,16917,15935,982,5.800000
CN4004300000000,40,043,"Dewey County, OK",2014,2376,2301,75,3.200000
CN4004500000000,40,045,"Ellis County, OK",2014,2342,2271,71,3.000000
CN4004700000000,40,047,"Garfield County, OK",2014,29313,28265,1048,3.600000
CN4004900000000,40,049,"Garvin County, OK",2014,12553,12041,512,4.100000
CN4005100000000,40,051,"Grady County, OK",2014,25415,24403,1012,4.000000
CN4005300000000,40,053,"Grant County, OK",2014,2774,2699,75,2.700000
CN4005500000000,40,055,"Greer County, OK",2014,2032,1936,96,4.700000
CN4005700000000,40,057,"Harmon County, OK",2014,1281,1229,52,4.100000
CN4005900000000,40,059,"Harper County, OK",2014,1958,1903,55,2.800000
CN4006100000000,40,061,"Haskell County, OK",2014,4311,4001,310,7.200000
CN4006300000000,40,063,"Hughes County, OK",2014,5631,5236,395,7.000000
CN4006500000000,40,065,"Jackson County, OK",2014,10536,10074,462,4.400000
CN4006700000000,40,067,"Jefferson County, OK",2014,2574,2453,121,4.700000
CN4006900000000,40,069,"Johnston County, OK",2014,3562,3313,249,7.000000
CN4007100000000,40,071,"Kay County, OK",2014,19196,18105,1091,5.700000
CN4007300000000,40,073,"Kingfisher County, OK",2014,7866,7622,244,3.100000
CN4007500000000,40,075,"Kiowa County, OK",2014,4021,3856,165,4.100000
CN4007700000000,40,077,"Latimer County, OK",2014,3964,3666,298,7.500000
CN4007900000000,40,079,"Le Flore County, OK",2014,19283,17942,1341,7.000000
CN4008100000000,40,081,"Lincoln County, OK",2014,15430,14731,699,4.500000
CN4008300000000,40,083,"Logan County, OK",2014,20674,19846,828,4.000000
CN4008500000000,40,085,"Love County, OK",2014,5345,5150,195,3.600000
CN4008700000000,40,087,"McClain County, OK",2014,17798,17138,660,3.700000
CN4008900000000,40,089,"McCurtain County, OK",2014,14156,13030,1126,8.000000
CN4009100000000,40,091,"McIntosh County, OK",2014,6969,6349,620,8.900000
CN4009300000000,40,093,"Major County, OK",2014,4324,4210,114,2.600000
CN4009500000000,40,095,"Marshall County, OK",2014,6895,6563,332,4.800000
CN4009700000000,40,097,"Mayes County, OK",2014,18554,17638,916,4.900000
CN4009900000000,40,099,"Murray County, OK",2014,6485,6212,273,4.200000
CN4010100000000,40,101,"Muskogee County, OK",2014,28988,27310,1678,5.800000
CN4010300000000,40,103,"Noble County, OK",2014,5505,5303,202,3.700000
CN4010500000000,40,105,"Nowata County, OK",2014,4739,4449,290,6.100000
CN4010700000000,40,107,"Okfuskee County, OK",2014,4455,4188,267,6.000000
CN4010900000000,40,109,"Oklahoma County, OK",2014,365832,350480,15352,4.200000
CN4011100000000,40,111,"Okmulgee County, OK",2014,16152,15063,1089,6.700000
CN4011300000000,40,113,"Osage County, OK",2014,21013,19930,1083,5.200000
CN4011500000000,40,115,"Ottawa County, OK",2014,13663,12758,905,6.600000
CN4011700000000,40,117,"Pawnee County, OK",2014,7365,6976,389,5.300000
CN4011900000000,40,119,"Payne County, OK",2014,38126,36706,1420,3.700000
CN4012100000000,40,121,"Pittsburg County, OK",2014,16989,15949,1040,6.100000
CN4012300000000,40,123,"Pontotoc County, OK",2014,17619,16850,769,4.400000
CN4012500000000,40,125,"Pottawatomie County, OK",2014,31853,30342,1511,4.700000
CN4012700000000,40,127,"Pushmataha County, OK",2014,4680,4335,345,7.400000
CN4012900000000,40,129,"Roger Mills County, OK",2014,1777,1726,51,2.900000
CN4013100000000,40,131,"Rogers County, OK",2014,43412,41586,1826,4.200000
CN4013300000000,40,133,"Seminole County, OK",2014,9452,8809,643,6.800000
CN4013500000000,40,135,"Sequoyah County, OK",2014,16566,15405,1161,7.000000
CN4013700000000,40,137,"Stephens County, OK",2014,19958,19048,910,4.600000
CN4013900000000,40,139,"Texas County, OK",2014,9281,8935,346,3.700000
CN4014100000000,40,141,"Tillman County, OK",2014,3271,3117,154,4.700000
CN4014300000000,40,143,"Tulsa County, OK",2014,308610,295315,13295,4.300000
CN4014500000000,40,145,"Wagoner County, OK",2014,35639,34131,1508,4.200000
CN4014700000000,40,147,"Washington County, OK",2014,24277,23241,1036,4.300000
CN4014900000000,40,149,"Washita County, OK",2014,5576,5383,193,3.500000
CN4015100000000,40,151,"Woods County, OK",2014,5193,5052,141,2.700000
CN4015300000000,40,153,"Woodward County, OK",2014,10671,10342,329,3.100000
CN4100100000000,41,001,"Baker County, OR",2014,6733,6157,576,8.600000
CN4100300000000,41,003,"Benton County, OR",2014,44298,41957,2341,5.300000
CN4100500000000,41,005,"Clackamas County, OR",2014,200428,187827,12601,6.300000
CN4100700000000,41,007,"Clatsop County, OR",2014,18093,16888,1205,6.700000
CN4100900000000,41,009,"Columbia County, OR",2014,22629,20727,1902,8.400000
CN4101100000000,41,011,"Coos County, OR",2014,26223,23819,2404,9.200000
CN4101300000000,41,013,"Crook County, OR",2014,9038,8127,911,10.100000
CN4101500000000,41,015,"Curry County, OR",2014,8678,7778,900,10.400000
CN4101700000000,41,017,"Deschutes County, OR",2014,80975,74591,6384,7.900000
CN4101900000000,41,019,"Douglas County, OR",2014,44165,40001,4164,9.400000
CN4102100000000,41,021,"Gilliam County, OR",2014,840,773,67,8.000000
CN4102300000000,41,023,"Grant County, OR",2014,3180,2837,343,10.800000
CN4102500000000,41,025,"Harney County, OR",2014,3331,3003,328,9.800000
CN4102700000000,41,027,"Hood River County, OR",2014,14004,13237,767,5.500000
CN4102900000000,41,029,"Jackson County, OR",2014,97163,88807,8356,8.600000
CN4103100000000,41,031,"Jefferson County, OR",2014,9388,8540,848,9.000000
CN4103300000000,41,033,"Josephine County, OR",2014,32963,29788,3175,9.600000
CN4103500000000,41,035,"Klamath County, OR",2014,28599,25832,2767,9.700000
CN4103700000000,41,037,"Lake County, OR",2014,3517,3172,345,9.800000
CN4103900000000,41,039,"Lane County, OR",2014,169571,157591,11980,7.100000
CN4104100000000,41,041,"Lincoln County, OR",2014,20641,18996,1645,8.000000
CN4104300000000,41,043,"Linn County, OR",2014,54142,49622,4520,8.300000
CN4104500000000,41,045,"Malheur County, OR",2014,12134,11138,996,8.200000
CN4104700000000,41,047,"Marion County, OR",2014,149591,138402,11189,7.500000
CN4104900000000,41,049,"Morrow County, OR",2014,5549,5156,393,7.100000
CN4105100000000,41,051,"Multnomah County, OR",2014,420329,394861,25468,6.100000
CN4105300000000,41,053,"Polk County, OR",2014,35393,32934,2459,6.900000
CN4105500000000,41,055,"Sherman County, OR",2014,877,811,66,7.500000
CN4105700000000,41,057,"Tillamook County, OR",2014,11151,10370,781,7.000000
CN4105900000000,41,059,"Umatilla County, OR",2014,35339,32538,2801,7.900000
CN4106100000000,41,061,"Union County, OR",2014,11726,10854,872,7.400000
CN4106300000000,41,063,"Wallowa County, OR",2014,3223,2894,329,10.200000
CN4106500000000,41,065,"Wasco County, OR",2014,13600,12688,912,6.700000
CN4106700000000,41,067,"Washington County, OR",2014,293505,276699,16806,5.700000
CN4106900000000,41,069,"Wheeler County, OR",2014,733,686,47,6.400000
CN4107100000000,41,071,"Yamhill County, OR",2014,50275,46967,3308,6.600000
CN4200100000000,42,001,"Adams County, PA",2014,54997,52525,2472,4.500000
CN4200300000000,42,003,"Allegheny County, PA",2014,644822,610519,34303,5.300000
CN4200500000000,42,005,"Armstrong County, PA",2014,33219,31083,2136,6.400000
CN4200700000000,42,007,"Beaver County, PA",2014,86031,80493,5538,6.400000
CN4200900000000,42,009,"Bedford County, PA",2014,24139,22562,1577,6.500000
CN4201100000000,42,011,"Berks County, PA",2014,210590,199065,11525,5.500000
CN4201300000000,42,013,"Blair County, PA",2014,60764,57344,3420,5.600000
CN4201500000000,42,015,"Bradford County, PA",2014,31489,29810,1679,5.300000
CN4201700000000,42,017,"Bucks County, PA",2014,335628,318156,17472,5.200000
CN4201900000000,42,019,"Butler County, PA",2014,96927,92045,4882,5.000000
CN4202100000000,42,021,"Cambria County, PA",2014,62959,58596,4363,6.900000
CN4202300000000,42,023,"Cameron County, PA",2014,2280,2120,160,7.000000
CN4202500000000,42,025,"Carbon County, PA",2014,31712,29507,2205,7.000000
CN4202700000000,42,027,"Centre County, PA",2014,77752,74533,3219,4.100000
CN4202900000000,42,029,"Chester County, PA",2014,272270,261025,11245,4.100000
CN4203100000000,42,031,"Clarion County, PA",2014,18327,17186,1141,6.200000
CN4203300000000,42,033,"Clearfield County, PA",2014,36576,33996,2580,7.100000
CN4203500000000,42,035,"Clinton County, PA",2014,18875,17517,1358,7.200000
CN4203700000000,42,037,"Columbia County, PA",2014,34175,32118,2057,6.000000
CN4203900000000,42,039,"Crawford County, PA",2014,41128,38774,2354,5.700000
CN4204100000000,42,041,"Cumberland County, PA",2014,125124,119554,5570,4.500000
CN4204300000000,42,043,"Dauphin County, PA",2014,139418,132047,7371,5.300000
CN4204500000000,42,045,"Delaware County, PA",2014,290026,274093,15933,5.500000
CN4204700000000,42,047,"Elk County, PA",2014,16311,15483,828,5.100000
CN4204900000000,42,049,"Erie County, PA",2014,134343,126112,8231,6.100000
CN4205100000000,42,051,"Fayette County, PA",2014,58560,54099,4461,7.600000
CN4205300000000,42,053,"Forest County, PA",2014,1927,1774,153,7.900000
CN4205500000000,42,055,"Franklin County, PA",2014,76085,72062,4023,5.300000
CN4205700000000,42,057,"Fulton County, PA",2014,7248,6755,493,6.800000
CN4205900000000,42,059,"Greene County, PA",2014,18395,17393,1002,5.400000
CN4206100000000,42,061,"Huntingdon County, PA",2014,19734,18208,1526,7.700000
CN4206300000000,42,063,"Indiana County, PA",2014,43193,40644,2549,5.900000
CN4206500000000,42,065,"Jefferson County, PA",2014,20742,19436,1306,6.300000
CN4206700000000,42,067,"Juniata County, PA",2014,11764,11109,655,5.600000
CN4206900000000,42,069,"Lackawanna County, PA",2014,106676,99688,6988,6.600000
CN4207100000000,42,071,"Lancaster County, PA",2014,270239,257890,12349,4.600000
CN4207300000000,42,073,"Lawrence County, PA",2014,42610,39964,2646,6.200000
CN4207500000000,42,075,"Lebanon County, PA",2014,70020,66599,3421,4.900000
CN4207700000000,42,077,"Lehigh County, PA",2014,181598,170631,10967,6.000000
CN4207900000000,42,079,"Luzerne County, PA",2014,158634,147126,11508,7.300000
CN4208100000000,42,081,"Lycoming County, PA",2014,61303,57582,3721,6.100000
CN4208300000000,42,083,"McKean County, PA",2014,19264,18056,1208,6.300000
CN4208500000000,42,085,"Mercer County, PA",2014,52892,49752,3140,5.900000
CN4208700000000,42,087,"Mifflin County, PA",2014,21032,19720,1312,6.200000
CN4208900000000,42,089,"Monroe County, PA",2014,79673,73754,5919,7.400000
CN4209100000000,42,091,"Montgomery County, PA",2014,434429,414378,20051,4.600000
CN4209300000000,42,093,"Montour County, PA",2014,9232,8808,424,4.600000
CN4209500000000,42,095,"Northampton County, PA",2014,154841,145692,9149,5.900000
CN4209700000000,42,097,"Northumberland County, PA",2014,43945,41051,2894,6.600000
CN4209900000000,42,099,"Perry County, PA",2014,24040,22802,1238,5.100000
CN4210100000000,42,101,"Philadelphia County/city, PA",2014,689205,634036,55169,8.000000
CN4210300000000,42,103,"Pike County, PA",2014,25390,23527,1863,7.300000
CN4210500000000,42,105,"Potter County, PA",2014,7604,7055,549,7.200000
CN4210700000000,42,107,"Schuylkill County, PA",2014,68732,63956,4776,6.900000
CN4210900000000,42,109,"Snyder County, PA",2014,19804,18792,1012,5.100000
CN4211100000000,42,111,"Somerset County, PA",2014,34777,32280,2497,7.200000
CN4211300000000,42,113,"Sullivan County, PA",2014,3008,2824,184,6.100000
CN4211500000000,42,115,"Susquehanna County, PA",2014,21404,20160,1244,5.800000
CN4211700000000,42,117,"Tioga County, PA",2014,20386,18990,1396,6.800000
CN4211900000000,42,119,"Union County, PA",2014,19132,18186,946,4.900000
CN4212100000000,42,121,"Venango County, PA",2014,24613,23162,1451,5.900000
CN4212300000000,42,123,"Warren County, PA",2014,20078,19024,1054,5.200000
CN4212500000000,42,125,"Washington County, PA",2014,105860,99814,6046,5.700000
CN4212700000000,42,127,"Wayne County, PA",2014,22262,20864,1398,6.300000
CN4212900000000,42,129,"Westmoreland County, PA",2014,184190,173753,10437,5.700000
CN4213100000000,42,131,"Wyoming County, PA",2014,14142,13190,952,6.700000
CN4213300000000,42,133,"York County, PA",2014,229957,217689,12268,5.300000
CN4400100000000,44,001,"Bristol County, RI",2014,26256,24565,1691,6.400000
CN4400300000000,44,003,"Kent County, RI",2014,91195,84635,6560,7.200000
CN4400500000000,44,005,"Newport County, RI",2014,44106,41157,2949,6.700000
CN4400700000000,44,007,"Providence County, RI",2014,322238,295871,26367,8.200000
CN4400900000000,44,009,"Washington County, RI",2014,69539,64675,4864,7.000000
CN4500100000000,45,001,"Abbeville County, SC",2014,10457,9658,799,7.600000
CN4500300000000,45,003,"Aiken County, SC",2014,72669,67996,4673,6.400000
CN4500500000000,45,005,"Allendale County, SC",2014,2890,2539,351,12.100000
CN4500700000000,45,007,"Anderson County, SC",2014,85879,80813,5066,5.900000
CN4500900000000,45,009,"Bamberg County, SC",2014,5577,4930,647,11.600000
CN4501100000000,45,011,"Barnwell County, SC",2014,8705,7868,837,9.600000
CN4501300000000,45,013,"Beaufort County, SC",2014,68502,64625,3877,5.700000
CN4501500000000,45,015,"Berkeley County, SC",2014,89661,84326,5335,6.000000
CN4501700000000,45,017,"Calhoun County, SC",2014,6917,6367,550,8.000000
CN4501900000000,45,019,"Charleston County, SC",2014,189718,179962,9756,5.100000
CN4502100000000,45,021,"Cherokee County, SC",2014,23475,21537,1938,8.300000
CN4502300000000,45,023,"Chester County, SC",2014,13608,12311,1297,9.500000
CN4502500000000,45,025,"Chesterfield County, SC",2014,21096,19642,1454,6.900000
CN4502700000000,45,027,"Clarendon County, SC",2014,12909,11813,1096,8.500000
CN4502900000000,45,029,"Colleton County, SC",2014,16660,15394,1266,7.600000
CN4503100000000,45,031,"Darlington County, SC",2014,29503,27158,2345,7.900000
CN4503300000000,45,033,"Dillon County, SC",2014,12512,11304,1208,9.700000
CN4503500000000,45,035,"Dorchester County, SC",2014,69376,65356,4020,5.800000
CN4503700000000,45,037,"Edgefield County, SC",2014,10512,9804,708,6.700000
CN4503900000000,45,039,"Fairfield County, SC",2014,10015,9153,862,8.600000
CN4504100000000,45,041,"Florence County, SC",2014,63830,59197,4633,7.300000
CN4504300000000,45,043,"Georgetown County, SC",2014,24859,22805,2054,8.300000
CN4504500000000,45,045,"Greenville County, SC",2014,231979,219660,12319,5.300000
CN4504700000000,45,047,"Greenwood County, SC",2014,31392,29212,2180,6.900000
CN4504900000000,45,049,"Hampton County, SC",2014,8299,7658,641,7.700000
CN4505100000000,45,051,"Horry County, SC",2014,132999,123337,9662,7.300000
CN4505300000000,45,053,"Jasper County, SC",2014,11307,10663,644,5.700000
CN4505500000000,45,055,"Kershaw County, SC",2014,27917,26153,1764,6.300000
CN4505700000000,45,057,"Lancaster County, SC",2014,34382,31891,2491,7.200000
CN4505900000000,45,059,"Laurens County, SC",2014,29779,27717,2062,6.900000
CN4506100000000,45,061,"Lee County, SC",2014,6406,5824,582,9.100000
CN4506300000000,45,063,"Lexington County, SC",2014,138534,131473,7061,5.100000
CN4506500000000,45,065,"McCormick County, SC",2014,3516,3239,277,7.900000
CN4506700000000,45,067,"Marion County, SC",2014,12819,11476,1343,10.500000
CN4506900000000,45,069,"Marlboro County, SC",2014,9944,8891,1053,10.600000
CN4507100000000,45,071,"Newberry County, SC",2014,18297,17256,1041,5.700000
CN4507300000000,45,073,"Oconee County, SC",2014,33963,31809,2154,6.300000
CN4507500000000,45,075,"Orangeburg County, SC",2014,38070,33778,4292,11.300000
CN4507700000000,45,077,"Pickens County, SC",2014,54686,51301,3385,6.200000
CN4507900000000,45,079,"Richland County, SC",2014,191663,180099,11564,6.000000
CN4508100000000,45,081,"Saluda County, SC",2014,8629,8139,490,5.700000
CN4508300000000,45,083,"Spartanburg County, SC",2014,134890,126373,8517,6.300000
CN4508500000000,45,085,"Sumter County, SC",2014,43964,40741,3223,7.300000
CN4508700000000,45,087,"Union County, SC",2014,11498,10513,985,8.600000
CN4508900000000,45,089,"Williamsburg County, SC",2014,12712,11451,1261,9.900000
CN4509100000000,45,091,"York County, SC",2014,120614,112924,7690,6.400000
CN4600300000000,46,003,"Aurora County, SD",2014,1616,1575,41,2.500000
CN4600500000000,46,005,"Beadle County, SD",2014,9452,9159,293,3.100000
CN4600700000000,46,007,"Bennett County, SD",2014,1132,1069,63,5.600000
CN4600900000000,46,009,"Bon Homme County, SD",2014,3000,2915,85,2.800000
CN4601100000000,46,011,"Brookings County, SD",2014,18185,17616,569,3.100000
CN4601300000000,46,013,"Brown County, SD",2014,21036,20428,608,2.900000
CN4601500000000,46,015,"Brule County, SD",2014,2592,2508,84,3.200000
CN4601700000000,46,017,"Buffalo County, SD",2014,727,670,57,7.800000
CN4601900000000,46,019,"Butte County, SD",2014,5086,4913,173,3.400000
CN4602100000000,46,021,"Campbell County, SD",2014,835,807,28,3.400000
CN4602300000000,46,023,"Charles Mix County, SD",2014,4053,3900,153,3.800000
CN4602500000000,46,025,"Clark County, SD",2014,1987,1910,77,3.900000
CN4602700000000,46,027,"Clay County, SD",2014,7137,6892,245,3.400000
CN4602900000000,46,029,"Codington County, SD",2014,15423,14916,507,3.300000
CN4603100000000,46,031,"Corson County, SD",2014,1505,1416,89,5.900000
CN4603300000000,46,033,"Custer County, SD",2014,4039,3859,180,4.500000
CN4603500000000,46,035,"Davison County, SD",2014,11331,11014,317,2.800000
CN4603700000000,46,037,"Day County, SD",2014,2906,2753,153,5.300000
CN4603900000000,46,039,"Deuel County, SD",2014,2337,2212,125,5.300000
CN4604100000000,46,041,"Dewey County, SD",2014,2358,2016,342,14.500000
CN4604300000000,46,043,"Douglas County, SD",2014,1741,1690,51,2.900000
CN4604500000000,46,045,"Edmunds County, SD",2014,2293,2237,56,2.400000
CN4604700000000,46,047,"Fall River County, SD",2014,3026,2886,140,4.600000
CN4604900000000,46,049,"Faulk County, SD",2014,1156,1120,36,3.100000
CN4605100000000,46,051,"Grant County, SD",2014,4745,4576,169,3.600000
CN4605300000000,46,053,"Gregory County, SD",2014,2086,2015,71,3.400000
CN4605500000000,46,055,"Haakon County, SD",2014,1096,1066,30,2.700000
CN4605700000000,46,057,"Hamlin County, SD",2014,3158,3050,108,3.400000
CN4605900000000,46,059,"Hand County, SD",2014,1832,1785,47,2.600000
CN4606100000000,46,061,"Hanson County, SD",2014,1815,1752,63,3.500000
CN4606300000000,46,063,"Harding County, SD",2014,781,762,19,2.400000
CN4606500000000,46,065,"Hughes County, SD",2014,10008,9750,258,2.600000
CN4606700000000,46,067,"Hutchinson County, SD",2014,3665,3560,105,2.900000
CN4606900000000,46,069,"Hyde County, SD",2014,703,683,20,2.800000
CN4607100000000,46,071,"Jackson County, SD",2014,1316,1245,71,5.400000
CN4607300000000,46,073,"Jerauld County, SD",2014,1217,1186,31,2.500000
CN4607500000000,46,075,"Jones County, SD",2014,622,600,22,3.500000
CN4607700000000,46,077,"Kingsbury County, SD",2014,2928,2842,86,2.900000
CN4607900000000,46,079,"Lake County, SD",2014,6280,6056,224,3.600000
CN4608100000000,46,081,"Lawrence County, SD",2014,12700,12256,444,3.500000
CN4608300000000,46,083,"Lincoln County, SD",2014,29100,28402,698,2.400000
CN4608500000000,46,085,"Lyman County, SD",2014,1817,1740,77,4.200000
CN4608700000000,46,087,"McCook County, SD",2014,3211,3126,85,2.600000
CN4608900000000,46,089,"McPherson County, SD",2014,1142,1098,44,3.900000
CN4609100000000,46,091,"Marshall County, SD",2014,2542,2438,104,4.100000
CN4609300000000,46,093,"Meade County, SD",2014,13636,13189,447,3.300000
CN4609500000000,46,095,"Mellette County, SD",2014,824,774,50,6.100000
CN4609700000000,46,097,"Miner County, SD",2014,1243,1203,40,3.200000
CN4609900000000,46,099,"Minnehaha County, SD",2014,104575,101458,3117,3.000000
CN4610100000000,46,101,"Moody County, SD",2014,3979,3815,164,4.100000
CN4610300000000,46,103,"Pennington County, SD",2014,53691,51878,1813,3.400000
CN4610500000000,46,105,"Perkins County, SD",2014,1557,1505,52,3.300000
CN4610700000000,46,107,"Potter County, SD",2014,1213,1172,41,3.400000
CN4610900000000,46,109,"Roberts County, SD",2014,4912,4680,232,4.700000
CN4611100000000,46,111,"Sanborn County, SD",2014,1259,1227,32,2.500000
CN4611300000000,46,113,"Shannon County, SD",2014,3642,3163,479,13.200000
CN4611500000000,46,115,"Spink County, SD",2014,3398,3278,120,3.500000
CN4611700000000,46,117,"Stanley County, SD",2014,1879,1831,48,2.600000
CN4611900000000,46,119,"Sully County, SD",2014,892,867,25,2.800000
CN4612100000000,46,121,"Todd County, SD",2014,3093,2825,268,8.700000
CN4612300000000,46,123,"Tripp County, SD",2014,3128,3028,100,3.200000
CN4612500000000,46,125,"Turner County, SD",2014,4792,4655,137,2.900000
CN4612700000000,46,127,"Union County, SD",2014,7973,7678,295,3.700000
CN4612900000000,46,129,"Walworth County, SD",2014,2393,2267,126,5.300000
CN4613500000000,46,135,"Yankton County, SD",2014,11398,11056,342,3.000000
CN4613700000000,46,137,"Ziebach County, SD",2014,1014,955,59,5.800000
CN4700100000000,47,001,"Anderson County, TN",2014,33091,30830,2261,6.800000
CN4700300000000,47,003,"Bedford County, TN",2014,19349,17919,1430,7.400000
CN4700500000000,47,005,"Benton County, TN",2014,6680,6082,598,9.000000
CN4700700000000,47,007,"Bledsoe County, TN",2014,4201,3835,366,8.700000
CN4700900000000,47,009,"Blount County, TN",2014,58296,54788,3508,6.000000
CN4701100000000,47,011,"Bradley County, TN",2014,48032,45054,2978,6.200000
CN4701300000000,47,013,"Campbell County, TN",2014,14857,13467,1390,9.400000
CN4701500000000,47,015,"Cannon County, TN",2014,5832,5470,362,6.200000
CN4701700000000,47,017,"Carroll County, TN",2014,12465,11203,1262,10.100000
CN4701900000000,47,019,"Carter County, TN",2014,23873,22056,1817,7.600000
CN4702100000000,47,021,"Cheatham County, TN",2014,19825,18733,1092,5.500000
CN4702300000000,47,023,"Chester County, TN",2014,8037,7473,564,7.000000
CN4702500000000,47,025,"Claiborne County, TN",2014,12594,11499,1095,8.700000
CN4702700000000,47,027,"Clay County, TN",2014,2966,2692,274,9.200000
CN4702900000000,47,029,"Cocke County, TN",2014,14483,13166,1317,9.100000
CN4703100000000,47,031,"Coffee County, TN",2014,24462,22920,1542,6.300000
CN4703300000000,47,033,"Crockett County, TN",2014,6784,6251,533,7.900000
CN4703500000000,47,035,"Cumberland County, TN",2014,22882,21047,1835,8.000000
CN4703700000000,47,037,"Davidson County, TN",2014,353770,335888,17882,5.100000
CN4703900000000,47,039,"Decatur County, TN",2014,4735,4279,456,9.600000
CN4704100000000,47,041,"DeKalb County, TN",2014,7331,6747,584,8.000000
CN4704300000000,47,043,"Dickson County, TN",2014,23597,22126,1471,6.200000
CN4704500000000,47,045,"Dyer County, TN",2014,16513,15133,1380,8.400000
CN4704700000000,47,047,"Fayette County, TN",2014,17589,16274,1315,7.500000
CN4704900000000,47,049,"Fentress County, TN",2014,7096,6503,593,8.400000
CN4705100000000,47,051,"Franklin County, TN",2014,19561,18361,1200,6.100000
CN4705300000000,47,053,"Gibson County, TN",2014,21130,19223,1907,9.000000
CN4705500000000,47,055,"Giles County, TN",2014,14210,13314,896,6.300000
CN4705700000000,47,057,"Grainger County, TN",2014,9153,8402,751,8.200000
CN4705900000000,47,059,"Greene County, TN",2014,29540,27098,2442,8.300000
CN4706100000000,47,061,"Grundy County, TN",2014,5064,4589,475,9.400000
CN4706300000000,47,063,"Hamblen County, TN",2014,26295,24374,1921,7.300000
CN4706500000000,47,065,"Hamilton County, TN",2014,163306,152992,10314,6.300000
CN4706700000000,47,067,"Hancock County, TN",2014,2058,1853,205,10.000000
CN4706900000000,47,069,"Hardeman County, TN",2014,9510,8612,898,9.400000
CN4707100000000,47,071,"Hardin County, TN",2014,10426,9484,942,9.000000
CN4707300000000,47,073,"Hawkins County, TN",2014,23798,22068,1730,7.300000
CN4707500000000,47,075,"Haywood County, TN",2014,7715,6950,765,9.900000
CN4707700000000,47,077,"Henderson County, TN",2014,12127,11064,1063,8.800000
CN4707900000000,47,079,"Henry County, TN",2014,13818,12681,1137,8.200000
CN4708100000000,47,081,"Hickman County, TN",2014,10356,9669,687,6.600000
CN4708300000000,47,083,"Houston County, TN",2014,3290,2963,327,9.900000
CN4708500000000,47,085,"Humphreys County, TN",2014,8236,7577,659,8.000000
CN4708700000000,47,087,"Jackson County, TN",2014,4426,4039,387,8.700000
CN4708900000000,47,089,"Jefferson County, TN",2014,22784,21075,1709,7.500000
CN4709100000000,47,091,"Johnson County, TN",2014,7075,6582,493,7.000000
CN4709300000000,47,093,"Knox County, TN",2014,223824,211557,12267,5.500000
CN4709500000000,47,095,"Lake County, TN",2014,2109,1914,195,9.200000
CN4709700000000,47,097,"Lauderdale County, TN",2014,9812,8841,971,9.900000
CN4709900000000,47,099,"Lawrence County, TN",2014,17575,16130,1445,8.200000
CN4710100000000,47,101,"Lewis County, TN",2014,4869,4431,438,9.000000
CN4710300000000,47,103,"Lincoln County, TN",2014,15235,14421,814,5.300000
CN4710500000000,47,105,"Loudon County, TN",2014,21647,20206,1441,6.700000
CN4710700000000,47,107,"McMinn County, TN",2014,22230,20538,1692,7.600000
CN4710900000000,47,109,"McNairy County, TN",2014,8944,8000,944,10.600000
CN4711100000000,47,111,"Macon County, TN",2014,9893,9250,643,6.500000
CN4711300000000,47,113,"Madison County, TN",2014,46229,43040,3189,6.900000
CN4711500000000,47,115,"Marion County, TN",2014,11596,10678,918,7.900000
CN4711700000000,47,117,"Marshall County, TN",2014,14360,13437,923,6.400000
CN4711900000000,47,119,"Maury County, TN",2014,40655,38160,2495,6.100000
CN4712100000000,47,121,"Meigs County, TN",2014,4852,4434,418,8.600000
CN4712300000000,47,123,"Monroe County, TN",2014,18913,17459,1454,7.700000
CN4712500000000,47,125,"Montgomery County, TN",2014,76102,70982,5120,6.700000
CN4712700000000,47,127,"Moore County, TN",2014,3289,3120,169,5.100000
CN4712900000000,47,129,"Morgan County, TN",2014,7874,7182,692,8.800000
CN4713100000000,47,131,"Obion County, TN",2014,12929,11700,1229,9.500000
CN4713300000000,47,133,"Overton County, TN",2014,9089,8367,722,7.900000
CN4713500000000,47,135,"Perry County, TN",2014,3029,2778,251,8.300000
CN4713700000000,47,137,"Pickett County, TN",2014,2281,2080,201,8.800000
CN4713900000000,47,139,"Polk County, TN",2014,7286,6702,584,8.000000
CN4714100000000,47,141,"Putnam County, TN",2014,31832,29649,2183,6.900000
CN4714300000000,47,143,"Rhea County, TN",2014,13155,12038,1117,8.500000
CN4714500000000,47,145,"Roane County, TN",2014,22640,20954,1686,7.400000
CN4714700000000,47,147,"Robertson County, TN",2014,33390,31490,1900,5.700000
CN4714900000000,47,149,"Rutherford County, TN",2014,146720,138984,7736,5.300000
CN4715100000000,47,151,"Scott County, TN",2014,8198,7234,964,11.800000
CN4715300000000,47,153,"Sequatchie County, TN",2014,5711,5286,425,7.400000
CN4715500000000,47,155,"Sevier County, TN",2014,48433,44959,3474,7.200000
CN4715700000000,47,157,"Shelby County, TN",2014,427588,394006,33582,7.900000
CN4715900000000,47,159,"Smith County, TN",2014,8424,7894,530,6.300000
CN4716100000000,47,161,"Stewart County, TN",2014,5217,4736,481,9.200000
CN4716300000000,47,163,"Sullivan County, TN",2014,69466,64819,4647,6.700000
CN4716500000000,47,165,"Sumner County, TN",2014,85191,80697,4494,5.300000
CN4716700000000,47,167,"Tipton County, TN",2014,27158,24894,2264,8.300000
CN4716900000000,47,169,"Trousdale County, TN",2014,3617,3361,256,7.100000
CN4717100000000,47,171,"Unicoi County, TN",2014,7125,6483,642,9.000000
CN4717300000000,47,173,"Union County, TN",2014,7205,6653,552,7.700000
CN4717500000000,47,175,"Van Buren County, TN",2014,2098,1896,202,9.600000
CN4717700000000,47,177,"Warren County, TN",2014,17153,15950,1203,7.000000
CN4717900000000,47,179,"Washington County, TN",2014,57121,53491,3630,6.400000
CN4718100000000,47,181,"Wayne County, TN",2014,6438,5872,566,8.800000
CN4718300000000,47,183,"Weakley County, TN",2014,15844,14480,1364,8.600000
CN4718500000000,47,185,"White County, TN",2014,11419,10561,858,7.500000
CN4718700000000,47,187,"Williamson County, TN",2014,101242,96638,4604,4.500000
CN4718900000000,47,189,"Wilson County, TN",2014,61274,58025,3249,5.300000
CN4800100000000,48,001,"Anderson County, TX",2014,21800,20756,1044,4.800000
CN4800300000000,48,003,"Andrews County, TX",2014,9587,9306,281,2.900000
CN4800500000000,48,005,"Angelina County, TX",2014,38124,36138,1986,5.200000
CN4800700000000,48,007,"Aransas County, TX",2014,10219,9660,559,5.500000
CN4800900000000,48,009,"Archer County, TX",2014,4232,4040,192,4.500000
CN4801100000000,48,011,"Armstrong County, TX",2014,1017,984,33,3.200000
CN4801300000000,48,013,"Atascosa County, TX",2014,20630,19627,1003,4.900000
CN4801500000000,48,015,"Austin County, TX",2014,14467,13790,677,4.700000
CN4801700000000,48,017,"Bailey County, TX",2014,3028,2873,155,5.100000
CN4801900000000,48,019,"Bandera County, TX",2014,9246,8811,435,4.700000
CN4802100000000,48,021,"Bastrop County, TX",2014,36886,35118,1768,4.800000
CN4802300000000,48,023,"Baylor County, TX",2014,1651,1580,71,4.300000
CN4802500000000,48,025,"Bee County, TX",2014,10958,10333,625,5.700000
CN4802700000000,48,027,"Bell County, TX",2014,135833,127940,7893,5.800000
CN4802900000000,48,029,"Bexar County, TX",2014,872682,832117,40565,4.600000
CN4803100000000,48,031,"Blanco County, TX",2014,5684,5476,208,3.700000
CN4803300000000,48,033,"Borden County, TX",2014,427,414,13,3.000000
CN4803500000000,48,035,"Bosque County, TX",2014,8168,7744,424,5.200000
CN4803700000000,48,037,"Bowie County, TX",2014,39921,37412,2509,6.300000
CN4803900000000,48,039,"Brazoria County, TX",2014,168400,159920,8480,5.000000
CN4804100000000,48,041,"Brazos County, TX",2014,104564,100476,4088,3.900000
CN4804300000000,48,043,"Brewster County, TX",2014,4141,3948,193,4.700000
CN4804500000000,48,045,"Briscoe County, TX",2014,653,625,28,4.300000
CN4804700000000,48,047,"Brooks County, TX",2014,2702,2497,205,7.600000
CN4804900000000,48,049,"Brown County, TX",2014,16020,15201,819,5.100000
CN4805100000000,48,051,"Burleson County, TX",2014,7790,7425,365,4.700000
CN4805300000000,48,053,"Burnet County, TX",2014,21598,20684,914,4.200000
CN4805500000000,48,055,"Caldwell County, TX",2014,17572,16675,897,5.100000
CN4805700000000,48,057,"Calhoun County, TX",2014,11091,10555,536,4.800000
CN4805900000000,48,059,"Callahan County, TX",2014,5950,5690,260,4.400000
CN4806100000000,48,061,"Cameron County, TX",2014,167645,153775,13870,8.300000
CN4806300000000,48,063,"Camp County, TX",2014,5244,4928,316,6.000000
CN4806500000000,48,065,"Carson County, TX",2014,3199,3092,107,3.300000
CN4806700000000,48,067,"Cass County, TX",2014,12402,11458,944,7.600000
CN4806900000000,48,069,"Castro County, TX",2014,3868,3712,156,4.000000
CN4807100000000,48,071,"Chambers County, TX",2014,17803,16791,1012,5.700000
CN4807300000000,48,073,"Cherokee County, TX",2014,21378,20129,1249,5.800000
CN4807500000000,48,075,"Childress County, TX",2014,2899,2793,106,3.700000
CN4807700000000,48,077,"Clay County, TX",2014,5131,4897,234,4.600000
CN4807900000000,48,079,"Cochran County, TX",2014,1421,1348,73,5.100000
CN4808100000000,48,081,"Coke County, TX",2014,1475,1413,62,4.200000
CN4808300000000,48,083,"Coleman County, TX",2014,3179,2989,190,6.000000
CN4808500000000,48,085,"Collin County, TX",2014,471554,450277,21277,4.500000
CN4808700000000,48,087,"Collingsworth County, TX",2014,1281,1228,53,4.100000
CN4808900000000,48,089,"Colorado County, TX",2014,10461,9999,462,4.400000
CN4809100000000,48,091,"Comal County, TX",2014,58965,56294,2671,4.500000
CN4809300000000,48,093,"Comanche County, TX",2014,5615,5344,271,4.800000
CN4809500000000,48,095,"Concho County, TX",2014,1423,1380,43,3.000000
CN4809700000000,48,097,"Cooke County, TX",2014,20722,19926,796,3.800000
CN4809900000000,48,099,"Coryell County, TX",2014,25294,23777,1517,6.000000
CN4810100000000,48,101,"Cottle County, TX",2014,667,629,38,5.700000
CN4810300000000,48,103,"Crane County, TX",2014,2059,1979,80,3.900000
CN4810500000000,48,105,"Crockett County, TX",2014,1936,1862,74,3.800000
CN4810700000000,48,107,"Crosby County, TX",2014,2796,2668,128,4.600000
CN4810900000000,48,109,"Culberson County, TX",2014,1016,974,42,4.100000
CN4811100000000,48,111,"Dallam County, TX",2014,3816,3701,115,3.000000
CN4811300000000,48,113,"Dallas County, TX",2014,1268571,1200663,67908,5.400000
CN4811500000000,48,115,"Dawson County, TX",2014,5008,4758,250,5.000000
CN4811700000000,48,117,"Deaf Smith County, TX",2014,9156,8823,333,3.600000
CN4811900000000,48,119,"Delta County, TX",2014,2707,2545,162,6.000000
CN4812100000000,48,121,"Denton County, TX",2014,412700,394540,18160,4.400000
CN4812300000000,48,123,"DeWitt County, TX",2014,10092,9708,384,3.800000
CN4812500000000,48,125,"Dickens County, TX",2014,756,708,48,6.300000
CN4812700000000,48,127,"Dimmit County, TX",2014,7689,7398,291,3.800000
CN4812900000000,48,129,"Donley County, TX",2014,1626,1547,79,4.900000
CN4813100000000,48,131,"Duval County, TX",2014,5626,5314,312,5.500000
CN4813300000000,48,133,"Eastland County, TX",2014,8452,8044,408,4.800000
CN4813500000000,48,135,"Ector County, TX",2014,83057,80240,2817,3.400000
CN4813700000000,48,137,"Edwards County, TX",2014,866,828,38,4.400000
CN4813900000000,48,139,"Ellis County, TX",2014,79731,75854,3877,4.900000
CN4814100000000,48,141,"El Paso County, TX",2014,347884,325240,22644,6.500000
CN4814300000000,48,143,"Erath County, TX",2014,20223,19376,847,4.200000
CN4814500000000,48,145,"Falls County, TX",2014,6785,6407,378,5.600000
CN4814700000000,48,147,"Fannin County, TX",2014,15479,14637,842,5.400000
CN4814900000000,48,149,"Fayette County, TX",2014,13237,12784,453,3.400000
CN4815100000000,48,151,"Fisher County, TX",2014,1879,1793,86,4.600000
CN4815300000000,48,153,"Floyd County, TX",2014,3101,2883,218,7.000000
CN4815500000000,48,155,"Foard County, TX",2014,585,560,25,4.300000
CN4815700000000,48,157,"Fort Bend County, TX",2014,341733,326385,15348,4.500000
CN4815900000000,48,159,"Franklin County, TX",2014,4745,4503,242,5.100000
CN4816100000000,48,161,"Freestone County, TX",2014,7760,7319,441,5.700000
CN4816300000000,48,163,"Frio County, TX",2014,10417,10051,366,3.500000
CN4816500000000,48,165,"Gaines County, TX",2014,9398,9096,302,3.200000
CN4816700000000,48,167,"Galveston County, TX",2014,159108,150302,8806,5.500000
CN4816900000000,48,169,"Garza County, TX",2014,2287,2207,80,3.500000
CN4817100000000,48,171,"Gillespie County, TX",2014,12563,12115,448,3.600000
CN4817300000000,48,173,"Glasscock County, TX",2014,779,758,21,2.700000
CN4817500000000,48,175,"Goliad County, TX",2014,3596,3450,146,4.100000
CN4817700000000,48,177,"Gonzales County, TX",2014,9941,9554,387,3.900000
CN4817900000000,48,179,"Gray County, TX",2014,9856,9455,401,4.100000
CN4818100000000,48,181,"Grayson County, TX",2014,60948,58005,2943,4.800000
CN4818300000000,48,183,"Gregg County, TX",2014,62036,59056,2980,4.800000
CN4818500000000,48,185,"Grimes County, TX",2014,11911,11343,568,4.800000
CN4818700000000,48,187,"Guadalupe County, TX",2014,71566,68501,3065,4.300000
CN4818900000000,48,189,"Hale County, TX",2014,13772,12483,1289,9.400000
CN4819100000000,48,191,"Hall County, TX",2014,1280,1200,80,6.300000
CN4819300000000,48,193,"Hamilton County, TX",2014,3593,3426,167,4.600000
CN4819500000000,48,195,"Hansford County, TX",2014,3287,3202,85,2.600000
CN4819700000000,48,197,"Hardeman County, TX",2014,1652,1569,83,5.000000
CN4819900000000,48,199,"Hardin County, TX",2014,25581,23994,1587,6.200000
CN4820100000000,48,201,"Harris County, TX",2014,2251628,2140826,110802,4.900000
CN4820300000000,48,203,"Harrison County, TX",2014,32409,30642,1767,5.500000
CN4820500000000,48,205,"Hartley County, TX",2014,2880,2806,74,2.600000
CN4820700000000,48,207,"Haskell County, TX",2014,2700,2592,108,4.000000
CN4820900000000,48,209,"Hays County, TX",2014,92604,88699,3905,4.200000
CN4821100000000,48,211,"Hemphill County, TX",2014,2567,2505,62,2.400000
CN4821300000000,48,213,"Henderson County, TX",2014,35125,33183,1942,5.500000
CN4821500000000,48,215,"Hidalgo County, TX",2014,334457,305428,29029,8.700000
CN4821700000000,48,217,"Hill County, TX",2014,15947,15106,841,5.300000
CN4821900000000,48,219,"Hockley County, TX",2014,12138,11666,472,3.900000
CN4822100000000,48,221,"Hood County, TX",2014,24400,23215,1185,4.900000
CN4822300000000,48,223,"Hopkins County, TX",2014,17581,16758,823,4.700000
CN4822500000000,48,225,"Houston County, TX",2014,9757,9245,512,5.200000
CN4822700000000,48,227,"Howard County, TX",2014,13687,13087,600,4.400000
CN4822900000000,48,229,"Hudspeth County, TX",2014,1310,1230,80,6.100000
CN4823100000000,48,231,"Hunt County, TX",2014,39024,36780,2244,5.800000
CN4823300000000,48,233,"Hutchinson County, TX",2014,10554,10092,462,4.400000
CN4823500000000,48,235,"Irion County, TX",2014,867,835,32,3.700000
CN4823700000000,48,237,"Jack County, TX",2014,4381,4216,165,3.800000
CN4823900000000,48,239,"Jackson County, TX",2014,7683,7383,300,3.900000
CN4824100000000,48,241,"Jasper County, TX",2014,14624,13442,1182,8.100000
CN4824300000000,48,243,"Jeff Davis County, TX",2014,1172,1129,43,3.700000
CN4824500000000,48,245,"Jefferson County, TX",2014,111452,102266,9186,8.200000
CN4824700000000,48,247,"Jim Hogg County, TX",2014,2275,2143,132,5.800000
CN4824900000000,48,249,"Jim Wells County, TX",2014,20248,19195,1053,5.200000
CN4825100000000,48,251,"Johnson County, TX",2014,74914,71185,3729,5.000000
CN4825300000000,48,253,"Jones County, TX",2014,5892,5571,321,5.400000
CN4825500000000,48,255,"Karnes County, TX",2014,6247,6011,236,3.800000
CN4825700000000,48,257,"Kaufman County, TX",2014,53886,51141,2745,5.100000
CN4825900000000,48,259,"Kendall County, TX",2014,18649,17902,747,4.000000
CN4826100000000,48,261,"Kenedy County, TX",2014,349,339,10,2.900000
CN4826300000000,48,263,"Kent County, TX",2014,525,508,17,3.200000
CN4826500000000,48,265,"Kerr County, TX",2014,21628,20688,940,4.300000
CN4826700000000,48,267,"Kimble County, TX",2014,2165,2082,83,3.800000
CN4826900000000,48,269,"King County, TX",2014,231,221,10,4.300000
CN4827100000000,48,271,"Kinney County, TX",2014,1223,1136,87,7.100000
CN4827300000000,48,273,"Kleberg County, TX",2014,15424,14594,830,5.400000
CN4827500000000,48,275,"Knox County, TX",2014,1745,1670,75,4.300000
CN4827700000000,48,277,"Lamar County, TX",2014,22250,20896,1354,6.100000
CN4827900000000,48,279,"Lamb County, TX",2014,6214,5857,357,5.700000
CN4828100000000,48,281,"Lampasas County, TX",2014,9126,8618,508,5.600000
CN4828300000000,48,283,"La Salle County, TX",2014,4599,4458,141,3.100000
CN4828500000000,48,285,"Lavaca County, TX",2014,9075,8721,354,3.900000
CN4828700000000,48,287,"Lee County, TX",2014,9332,8958,374,4.000000
CN4828900000000,48,289,"Leon County, TX",2014,7182,6799,383,5.300000
CN4829100000000,48,291,"Liberty County, TX",2014,31466,29290,2176,6.900000
CN4829300000000,48,293,"Limestone County, TX",2014,9282,8745,537,5.800000
CN4829500000000,48,295,"Lipscomb County, TX",2014,1743,1685,58,3.300000
CN4829700000000,48,297,"Live Oak County, TX",2014,6278,6060,218,3.500000
CN4829900000000,48,299,"Llano County, TX",2014,8154,7734,420,5.200000
CN4830100000000,48,301,"Loving County, TX",2014,80,76,4,5.000000
CN4830300000000,48,303,"Lubbock County, TX",2014,148679,142874,5805,3.900000
CN4830500000000,48,305,"Lynn County, TX",2014,2899,2773,126,4.300000
CN4830700000000,48,307,"McCulloch County, TX",2014,4110,3935,175,4.300000
CN4830900000000,48,309,"McLennan County, TX",2014,112604,106878,5726,5.100000
CN4831100000000,48,311,"McMullen County, TX",2014,1117,1098,19,1.700000
CN4831300000000,48,313,"Madison County, TX",2014,5075,4828,247,4.900000
CN4831500000000,48,315,"Marion County, TX",2014,4511,4225,286,6.300000
CN4831700000000,48,317,"Martin County, TX",2014,2703,2612,91,3.400000
CN4831900000000,48,319,"Mason County, TX",2014,1940,1850,90,4.600000
CN4832100000000,48,321,"Matagorda County, TX",2014,16892,15572,1320,7.800000
CN4832300000000,48,323,"Maverick County, TX",2014,23520,20960,2560,10.900000
CN4832500000000,48,325,"Medina County, TX",2014,20742,19741,1001,4.800000
CN4832700000000,48,327,"Menard County, TX",2014,901,859,42,4.700000
CN4832900000000,48,329,"Midland County, TX",2014,91588,88987,2601,2.800000
CN4833100000000,48,331,"Milam County, TX",2014,10244,9612,632,6.200000
CN4833300000000,48,333,"Mills County, TX",2014,2064,1973,91,4.400000
CN4833500000000,48,335,"Mitchell County, TX",2014,2923,2792,131,4.500000
CN4833700000000,48,337,"Montague County, TX",2014,10406,9998,408,3.900000
CN4833900000000,48,339,"Montgomery County, TX",2014,252448,241416,11032,4.400000
CN4834100000000,48,341,"Moore County, TX",2014,11395,10997,398,3.500000
CN4834300000000,48,343,"Morris County, TX",2014,5676,5241,435,7.700000
CN4834500000000,48,345,"Motley County, TX",2014,492,470,22,4.500000
CN4834700000000,48,347,"Nacogdoches County, TX",2014,28817,27267,1550,5.400000
CN4834900000000,48,349,"Navarro County, TX",2014,23435,22207,1228,5.200000
CN4835100000000,48,351,"Newton County, TX",2014,5621,5161,460,8.200000
CN4835300000000,48,353,"Nolan County, TX",2014,7122,6816,306,4.300000
CN4835500000000,48,355,"Nueces County, TX",2014,170802,162220,8582,5.000000
CN4835700000000,48,357,"Ochiltree County, TX",2014,5645,5475,170,3.000000
CN4835900000000,48,359,"Oldham County, TX",2014,971,935,36,3.700000
CN4836100000000,48,361,"Orange County, TX",2014,38114,35085,3029,7.900000
CN4836300000000,48,363,"Palo Pinto County, TX",2014,13450,12763,687,5.100000
CN4836500000000,48,365,"Panola County, TX",2014,12939,12319,620,4.800000
CN4836700000000,48,367,"Parker County, TX",2014,59755,57047,2708,4.500000
CN4836900000000,48,369,"Parmer County, TX",2014,5161,5000,161,3.100000
CN4837100000000,48,371,"Pecos County, TX",2014,6870,6584,286,4.200000
CN4837300000000,48,373,"Polk County, TX",2014,17343,16226,1117,6.400000
CN4837500000000,48,375,"Potter County, TX",2014,57734,55456,2278,3.900000
CN4837700000000,48,377,"Presidio County, TX",2014,3466,3064,402,11.600000
CN4837900000000,48,379,"Rains County, TX",2014,5470,5200,270,4.900000
CN4838100000000,48,381,"Randall County, TX",2014,68926,66555,2371,3.400000
CN4838300000000,48,383,"Reagan County, TX",2014,2052,1988,64,3.100000
CN4838500000000,48,385,"Real County, TX",2014,1066,1002,64,6.000000
CN4838700000000,48,387,"Red River County, TX",2014,4966,4578,388,7.800000
CN4838900000000,48,389,"Reeves County, TX",2014,5823,5584,239,4.100000
CN4839100000000,48,391,"Refugio County, TX",2014,3648,3491,157,4.300000
CN4839300000000,48,393,"Roberts County, TX",2014,443,428,15,3.400000
CN4839500000000,48,395,"Robertson County, TX",2014,7356,6971,385,5.200000
CN4839700000000,48,397,"Rockwall County, TX",2014,43404,41469,1935,4.500000
CN4839900000000,48,399,"Runnels County, TX",2014,5070,4860,210,4.100000
CN4840100000000,48,401,"Rusk County, TX",2014,24468,23270,1198,4.900000
CN4840300000000,48,403,"Sabine County, TX",2014,3599,3221,378,10.500000
CN4840500000000,48,405,"San Augustine County, TX",2014,2844,2570,274,9.600000
CN4840700000000,48,407,"San Jacinto County, TX",2014,11478,10817,661,5.800000
CN4840900000000,48,409,"San Patricio County, TX",2014,31155,29229,1926,6.200000
CN4841100000000,48,411,"San Saba County, TX",2014,2256,2152,104,4.600000
CN4841300000000,48,413,"Schleicher County, TX",2014,1802,1748,54,3.000000
CN4841500000000,48,415,"Scurry County, TX",2014,8659,8369,290,3.300000
CN4841700000000,48,417,"Shackelford County, TX",2014,2443,2376,67,2.700000
CN4841900000000,48,419,"Shelby County, TX",2014,11678,10998,680,5.800000
CN4842100000000,48,421,"Sherman County, TX",2014,1520,1471,49,3.200000
CN4842300000000,48,423,"Smith County, TX",2014,102952,97622,5330,5.200000
CN4842500000000,48,425,"Somervell County, TX",2014,4221,4009,212,5.000000
CN4842700000000,48,427,"Starr County, TX",2014,26234,22690,3544,13.500000
CN4842900000000,48,429,"Stephens County, TX",2014,4313,4127,186,4.300000
CN4843100000000,48,431,"Sterling County, TX",2014,805,783,22,2.700000
CN4843300000000,48,433,"Stonewall County, TX",2014,717,689,28,3.900000
CN4843500000000,48,435,"Sutton County, TX",2014,2076,2003,73,3.500000
CN4843700000000,48,437,"Swisher County, TX",2014,2909,2730,179,6.200000
CN4843900000000,48,439,"Tarrant County, TX",2014,998520,948786,49734,5.000000
CN4844100000000,48,441,"Taylor County, TX",2014,65174,62435,2739,4.200000
CN4844300000000,48,443,"Terrell County, TX",2014,506,485,21,4.200000
CN4844500000000,48,445,"Terry County, TX",2014,5608,5363,245,4.400000
CN4844700000000,48,447,"Throckmorton County, TX",2014,838,805,33,3.900000
CN4844900000000,48,449,"Titus County, TX",2014,13075,12253,822,6.300000
CN4845100000000,48,451,"Tom Green County, TX",2014,54752,52541,2211,4.000000
CN4845300000000,48,453,"Travis County, TX",2014,649426,623322,26104,4.000000
CN4845500000000,48,455,"Trinity County, TX",2014,5600,5265,335,6.000000
CN4845700000000,48,457,"Tyler County, TX",2014,7621,7011,610,8.000000
CN4845900000000,48,459,"Upshur County, TX",2014,18659,17709,950,5.100000
CN4846100000000,48,461,"Upton County, TX",2014,1869,1810,59,3.200000
CN4846300000000,48,463,"Uvalde County, TX",2014,11706,11036,670,5.700000
CN4846500000000,48,465,"Val Verde County, TX",2014,19610,18494,1116,5.700000
CN4846700000000,48,467,"Van Zandt County, TX",2014,24071,22808,1263,5.200000
CN4846900000000,48,469,"Victoria County, TX",2014,46553,44624,1929,4.100000
CN4847100000000,48,471,"Walker County, TX",2014,23290,22038,1252,5.400000
CN4847300000000,48,473,"Waller County, TX",2014,21272,20202,1070,5.000000
CN4847500000000,48,475,"Ward County, TX",2014,6004,5794,210,3.500000
CN4847700000000,48,477,"Washington County, TX",2014,15898,15175,723,4.500000
CN4847900000000,48,479,"Webb County, TX",2014,111815,106141,5674,5.100000
CN4848100000000,48,481,"Wharton County, TX",2014,21768,20749,1019,4.700000
CN4848300000000,48,483,"Wheeler County, TX",2014,3129,3018,111,3.500000
CN4848500000000,48,485,"Wichita County, TX",2014,57054,54276,2778,4.900000
CN4848700000000,48,487,"Wilbarger County, TX",2014,5382,5117,265,4.900000
CN4848900000000,48,489,"Willacy County, TX",2014,7250,6355,895,12.300000
CN4849100000000,48,491,"Williamson County, TX",2014,254484,243539,10945,4.300000
CN4849300000000,48,493,"Wilson County, TX",2014,22692,21757,935,4.100000
CN4849500000000,48,495,"Winkler County, TX",2014,3369,3226,143,4.200000
CN4849700000000,48,497,"Wise County, TX",2014,28873,27486,1387,4.800000
CN4849900000000,48,499,"Wood County, TX",2014,16781,15790,991,5.900000
CN4850100000000,48,501,"Yoakum County, TX",2014,4334,4203,131,3.000000
CN4850300000000,48,503,"Young County, TX",2014,8749,8392,357,4.100000
CN4850500000000,48,505,"Zapata County, TX",2014,7022,6658,364,5.200000
CN4850700000000,48,507,"Zavala County, TX",2014,3852,3376,476,12.400000
CN4900100000000,49,001,"Beaver County, UT",2014,2968,2851,117,3.900000
CN4900300000000,49,003,"Box Elder County, UT",2014,23557,22650,907,3.900000
CN4900500000000,49,005,"Cache County, UT",2014,58894,57003,1891,3.200000
CN4900700000000,49,007,"Carbon County, UT",2014,8701,8251,450,5.200000
CN4900900000000,49,009,"Daggett County, UT",2014,430,412,18,4.200000
CN4901100000000,49,011,"Davis County, UT",2014,155339,149809,5530,3.600000
CN4901300000000,49,013,"Duchesne County, UT",2014,9602,9257,345,3.600000
CN4901500000000,49,015,"Emery County, UT",2014,4613,4372,241,5.200000
CN4901700000000,49,017,"Garfield County, UT",2014,2726,2491,235,8.600000
CN4901900000000,49,019,"Grand County, UT",2014,5515,5171,344,6.200000
CN4902100000000,49,021,"Iron County, UT",2014,19950,19057,893,4.500000
CN4902300000000,49,023,"Juab County, UT",2014,4817,4622,195,4.000000
CN4902500000000,49,025,"Kane County, UT",2014,3581,3417,164,4.600000
CN4902700000000,49,027,"Millard County, UT",2014,6009,5797,212,3.500000
CN4902900000000,49,029,"Morgan County, UT",2014,4587,4433,154,3.400000
CN4903100000000,49,031,"Piute County, UT",2014,462,431,31,6.700000
CN4903300000000,49,033,"Rich County, UT",2014,1002,965,37,3.700000
CN4903500000000,49,035,"Salt Lake County, UT",2014,577571,556398,21173,3.700000
CN4903700000000,49,037,"San Juan County, UT",2014,5614,5193,421,7.500000
CN4903900000000,49,039,"Sanpete County, UT",2014,11078,10575,503,4.500000
CN4904100000000,49,041,"Sevier County, UT",2014,9278,8863,415,4.500000
CN4904300000000,49,043,"Summit County, UT",2014,22608,21849,759,3.400000
CN4904500000000,49,045,"Tooele County, UT",2014,28911,27540,1371,4.700000
CN4904700000000,49,047,"Uintah County, UT",2014,15926,15363,563,3.500000
CN4904900000000,49,049,"Utah County, UT",2014,255571,246669,8902,3.500000
CN4905100000000,49,051,"Wasatch County, UT",2014,12716,12251,465,3.700000
CN4905300000000,49,053,"Washington County, UT",2014,61496,58842,2654,4.300000
CN4905500000000,49,055,"Wayne County, UT",2014,1386,1256,130,9.400000
CN4905700000000,49,057,"Weber County, UT",2014,116198,111160,5038,4.300000
CN5000100000000,50,001,"Addison County, VT",2014,20982,20164,818,3.900000
CN5000300000000,50,003,"Bennington County, VT",2014,19052,18140,912,4.800000
CN5000500000000,50,005,"Caledonia County, VT",2014,15549,14768,781,5.000000
CN5000700000000,50,007,"Chittenden County, VT",2014,94810,91841,2969,3.100000
CN5000900000000,50,009,"Essex County, VT",2014,2857,2663,194,6.800000
CN5001100000000,50,011,"Franklin County, VT",2014,27362,26239,1123,4.100000
CN5001300000000,50,013,"Grand Isle County, VT",2014,4063,3872,191,4.700000
CN5001500000000,50,015,"Lamoille County, VT",2014,13916,13194,722,5.200000
CN5001700000000,50,017,"Orange County, VT",2014,16035,15412,623,3.900000
CN5001900000000,50,019,"Orleans County, VT",2014,13885,12996,889,6.400000
CN5002100000000,50,021,"Rutland County, VT",2014,32010,30456,1554,4.900000
CN5002300000000,50,023,"Washington County, VT",2014,34369,32983,1386,4.000000
CN5002500000000,50,025,"Windham County, VT",2014,23874,22861,1013,4.200000
CN5002700000000,50,027,"Windsor County, VT",2014,30100,28973,1127,3.700000
CN5100100000000,51,001,"Accomack County, VA",2014,16024,14984,1040,6.500000
CN5100300000000,51,003,"Albemarle County, VA",2014,54006,51631,2375,4.400000
CN5100500000000,51,005,"Alleghany County, VA",2014,7282,6843,439,6.000000
CN5100700000000,51,007,"Amelia County, VA",2014,6242,5914,328,5.300000
CN5100900000000,51,009,"Amherst County, VA",2014,15888,15027,861,5.400000
CN5101100000000,51,011,"Appomattox County, VA",2014,7188,6781,407,5.700000
CN5101300000000,51,013,"Arlington County, VA",2014,145962,141282,4680,3.200000
CN5101500000000,51,015,"Augusta County, VA",2014,37065,35329,1736,4.700000
CN5101700000000,51,017,"Bath County, VA",2014,2634,2517,117,4.400000
CN5101900000000,51,019,"Bedford County, VA",2014,38497,36537,1960,5.100000
CN5102100000000,51,021,"Bland County, VA",2014,2903,2729,174,6.000000
CN5102300000000,51,023,"Botetourt County, VA",2014,17829,16967,862,4.800000
CN5102500000000,51,025,"Brunswick County, VA",2014,6516,5980,536,8.200000
CN5102700000000,51,027,"Buchanan County, VA",2014,7874,7058,816,10.400000
CN5102900000000,51,029,"Buckingham County, VA",2014,6516,6087,429,6.600000
CN5103100000000,51,031,"Campbell County, VA",2014,27112,25677,1435,5.300000
CN5103300000000,51,033,"Caroline County, VA",2014,14731,13829,902,6.100000
CN5103500000000,51,035,"Carroll County, VA",2014,13228,12335,893,6.800000
CN5103600000000,51,036,"Charles City County, VA",2014,3819,3598,221,5.800000
CN5103700000000,51,037,"Charlotte County, VA",2014,5331,4972,359,6.700000
CN5104100000000,51,041,"Chesterfield County, VA",2014,177328,168286,9042,5.100000
CN5104300000000,51,043,"Clarke County, VA",2014,7642,7312,330,4.300000
CN5104500000000,51,045,"Craig County, VA",2014,2473,2318,155,6.300000
CN5104700000000,51,047,"Culpeper County, VA",2014,23463,22300,1163,5.000000
CN5104900000000,51,049,"Cumberland County, VA",2014,4531,4256,275,6.100000
CN5105100000000,51,051,"Dickenson County, VA",2014,5239,4720,519,9.900000
CN5105300000000,51,053,"Dinwiddie County, VA",2014,13659,12790,869,6.400000
CN5105700000000,51,057,"Essex County, VA",2014,5773,5406,367,6.400000
CN5105900000000,51,059,"Fairfax County, VA",2014,627615,601998,25617,4.100000
CN5106100000000,51,061,"Fauquier County, VA",2014,36018,34393,1625,4.500000
CN5106300000000,51,063,"Floyd County, VA",2014,8433,8046,387,4.600000
CN5106500000000,51,065,"Fluvanna County, VA",2014,13402,12830,572,4.300000
CN5106700000000,51,067,"Franklin County, VA",2014,27446,25992,1454,5.300000
CN5106900000000,51,069,"Frederick County, VA",2014,44689,42610,2079,4.700000
CN5107100000000,51,071,"Giles County, VA",2014,8273,7774,499,6.000000
CN5107300000000,51,073,"Gloucester County, VA",2014,19392,18452,940,4.800000
CN5107500000000,51,075,"Goochland County, VA",2014,10533,10033,500,4.700000
CN5107700000000,51,077,"Grayson County, VA",2014,7120,6569,551,7.700000
CN5107900000000,51,079,"Greene County, VA",2014,9954,9521,433,4.400000
CN5108100000000,51,081,"Greensville County, VA",2014,4279,3992,287,6.700000
CN5108300000000,51,083,"Halifax County, VA",2014,15675,14451,1224,7.800000
CN5108500000000,51,085,"Hanover County, VA",2014,56243,53695,2548,4.500000
CN5108700000000,51,087,"Henrico County, VA",2014,176843,167881,8962,5.100000
CN5108900000000,51,089,"Henry County, VA",2014,22926,21157,1769,7.700000
CN5109100000000,51,091,"Highland County, VA",2014,1434,1379,55,3.800000
CN5109300000000,51,093,"Isle of Wight County, VA",2014,18903,17907,996,5.300000
CN5109500000000,51,095,"James City County, VA",2014,33836,32157,1679,5.000000
CN5109700000000,51,097,"King and Queen County, VA",2014,3653,3442,211,5.800000
CN5109900000000,51,099,"King George County, VA",2014,12184,11543,641,5.300000
CN5110100000000,51,101,"King William County, VA",2014,8828,8371,457,5.200000
CN5110300000000,51,103,"Lancaster County, VA",2014,5416,5006,410,7.600000
CN5110500000000,51,105,"Lee County, VA",2014,8902,8173,729,8.200000
CN5110700000000,51,107,"Loudoun County, VA",2014,192351,184269,8082,4.200000
CN5110900000000,51,109,"Louisa County, VA",2014,18515,17578,937,5.100000
CN5111100000000,51,111,"Lunenburg County, VA",2014,5378,5058,320,6.000000
CN5111300000000,51,113,"Madison County, VA",2014,7309,7015,294,4.000000
CN5111500000000,51,115,"Mathews County, VA",2014,4177,3983,194,4.600000
CN5111700000000,51,117,"Mecklenburg County, VA",2014,12679,11697,982,7.700000
CN5111900000000,51,119,"Middlesex County, VA",2014,5066,4809,257,5.100000
CN5112100000000,51,121,"Montgomery County, VA",2014,50249,47713,2536,5.000000
CN5112500000000,51,125,"Nelson County, VA",2014,7519,7155,364,4.800000
CN5112700000000,51,127,"New Kent County, VA",2014,10944,10450,494,4.500000
CN5113100000000,51,131,"Northampton County, VA",2014,6080,5628,452,7.400000
CN5113300000000,51,133,"Northumberland County, VA",2014,5671,5271,400,7.100000
CN5113500000000,51,135,"Nottoway County, VA",2014,7100,6715,385,5.400000
CN5113700000000,51,137,"Orange County, VA",2014,16234,15386,848,5.200000
CN5113900000000,51,139,"Page County, VA",2014,11922,10959,963,8.100000
CN5114100000000,51,141,"Patrick County, VA",2014,7764,7259,505,6.500000
CN5114300000000,51,143,"Pittsylvania County, VA",2014,30418,28502,1916,6.300000
CN5114500000000,51,145,"Powhatan County, VA",2014,13761,13138,623,4.500000
CN5114700000000,51,147,"Prince Edward County, VA",2014,9831,9060,771,7.800000
CN5114900000000,51,149,"Prince George County, VA",2014,14925,13998,927,6.200000
CN5115300000000,51,153,"Prince William County, VA",2014,232150,220999,11151,4.800000
CN5115500000000,51,155,"Pulaski County, VA",2014,16871,15862,1009,6.000000
CN5115700000000,51,157,"Rappahannock County, VA",2014,3925,3742,183,4.700000
CN5115900000000,51,159,"Richmond County, VA",2014,4019,3796,223,5.500000
CN5116100000000,51,161,"Roanoke County, VA",2014,50391,48107,2284,4.500000
CN5116300000000,51,163,"Rockbridge County, VA",2014,10241,9691,550,5.400000
CN5116500000000,51,165,"Rockingham County, VA",2014,40800,38922,1878,4.600000
CN5116700000000,51,167,"Russell County, VA",2014,11307,10406,901,8.000000
CN5116900000000,51,169,"Scott County, VA",2014,9998,9413,585,5.900000
CN5117100000000,51,171,"Shenandoah County, VA",2014,21300,20237,1063,5.000000
CN5117300000000,51,173,"Smyth County, VA",2014,13422,12381,1041,7.800000
CN5117500000000,51,175,"Southampton County, VA",2014,9157,8698,459,5.000000
CN5117700000000,51,177,"Spotsylvania County, VA",2014,64372,60950,3422,5.300000
CN5117900000000,51,179,"Stafford County, VA",2014,66378,62895,3483,5.200000
CN5118100000000,51,181,"Surry County, VA",2014,3684,3460,224,6.100000
CN5118300000000,51,183,"Sussex County, VA",2014,4161,3852,309,7.400000
CN5118500000000,51,185,"Tazewell County, VA",2014,17303,15913,1390,8.000000
CN5118700000000,51,187,"Warren County, VA",2014,20128,19015,1113,5.500000
CN5119100000000,51,191,"Washington County, VA",2014,27983,26380,1603,5.700000
CN5119300000000,51,193,"Westmoreland County, VA",2014,9073,8499,574,6.300000
CN5119500000000,51,195,"Wise County, VA",2014,14415,13064,1351,9.400000
CN5119700000000,51,197,"Wythe County, VA",2014,13859,12974,885,6.400000
CN5119900000000,51,199,"York County, VA",2014,31977,30374,1603,5.000000
CN5151000000000,51,510,"Alexandria city, VA",2014,94209,90681,3528,3.700000
CN5152000000000,51,520,"Bristol city, VA",2014,7870,7368,502,6.400000
CN5153000000000,51,530,"Buena Vista city, VA",2014,3313,3122,191,5.800000
CN5154000000000,51,540,"Charlottesville city, VA",2014,24106,23075,1031,4.300000
CN5155000000000,51,550,"Chesapeake city, VA",2014,116496,110362,6134,5.300000
CN5157000000000,51,570,"Colonial Heights city, VA",2014,8773,8270,503,5.700000
CN5158000000000,51,580,"Covington city, VA",2014,2505,2304,201,8.000000
CN5159000000000,51,590,"Danville city, VA",2014,19714,18004,1710,8.700000
CN5159500000000,51,595,"Emporia city, VA",2014,2334,2142,192,8.200000
CN5160000000000,51,600,"Fairfax city, VA",2014,13212,12675,537,4.100000
CN5161000000000,51,610,"Falls Church city, VA",2014,7884,7601,283,3.600000
CN5162000000000,51,620,"Franklin city, VA",2014,3620,3334,286,7.900000
CN5163000000000,51,630,"Fredericksburg city, VA",2014,13814,12987,827,6.000000
CN5164000000000,51,640,"Galax city, VA",2014,2998,2782,216,7.200000
CN5165000000000,51,650,"Hampton city, VA",2014,65819,61413,4406,6.700000
CN5166000000000,51,660,"Harrisonburg city, VA",2014,24121,22655,1466,6.100000
CN5167000000000,51,670,"Hopewell city, VA",2014,9744,8900,844,8.700000
CN5167800000000,51,678,"Lexington city, VA",2014,2227,2050,177,7.900000
CN5168000000000,51,680,"Lynchburg city, VA",2014,35955,33672,2283,6.300000
CN5168300000000,51,683,"Manassas city, VA",2014,22330,21227,1103,4.900000
CN5168500000000,51,685,"Manassas Park city, VA",2014,8831,8431,400,4.500000
CN5169000000000,51,690,"Martinsville city, VA",2014,5559,5006,553,9.900000
CN5170000000000,51,700,"Newport News city, VA",2014,90692,85047,5645,6.200000
CN5171000000000,51,710,"Norfolk city, VA",2014,112971,105789,7182,6.400000
CN5172000000000,51,720,"Norton city, VA",2014,1812,1670,142,7.800000
CN5173000000000,51,730,"Petersburg city, VA",2014,13909,12428,1481,10.600000
CN5173500000000,51,735,"Poquoson city, VA",2014,6364,6076,288,4.500000
CN5174000000000,51,740,"Portsmouth city, VA",2014,45364,42128,3236,7.100000
CN5175000000000,51,750,"Radford city, VA",2014,8411,7853,558,6.600000
CN5176000000000,51,760,"Richmond city, VA",2014,111992,105134,6858,6.100000
CN5177000000000,51,770,"Roanoke city, VA",2014,50175,47230,2945,5.900000
CN5177500000000,51,775,"Salem city, VA",2014,13166,12494,672,5.100000
CN5179000000000,51,790,"Staunton city, VA",2014,12010,11390,620,5.200000
CN5180000000000,51,800,"Suffolk city, VA",2014,42076,39648,2428,5.800000
CN5181000000000,51,810,"Virginia Beach city, VA",2014,231784,220342,11442,4.900000
CN5182000000000,51,820,"Waynesboro city, VA",2014,10071,9533,538,5.300000
CN5183000000000,51,830,"Williamsburg city, VA",2014,6891,6403,488,7.100000
CN5184000000000,51,840,"Winchester city, VA",2014,14501,13775,726,5.000000
CN5300100000000,53,001,"Adams County, WA",2014,8521,7882,639,7.500000
CN5300300000000,53,003,"Asotin County, WA",2014,9700,9152,548,5.600000
CN5300500000000,53,005,"Benton County, WA",2014,90014,83088,6926,7.700000
CN5300700000000,53,007,"Chelan County, WA",2014,40985,38353,2632,6.400000
CN5300900000000,53,009,"Clallam County, WA",2014,26954,24620,2334,8.700000
CN5301100000000,53,011,"Clark County, WA",2014,208138,192688,15450,7.400000
CN5301300000000,53,013,"Columbia County, WA",2014,1759,1627,132,7.500000
CN5301500000000,53,015,"Cowlitz County, WA",2014,44025,40354,3671,8.300000
CN5301700000000,53,017,"Douglas County, WA",2014,19285,17888,1397,7.200000
CN5301900000000,53,019,"Ferry County, WA",2014,2471,2180,291,11.800000
CN5302100000000,53,021,"Franklin County, WA",2014,38266,34997,3269,8.500000
CN5302300000000,53,023,"Garfield County, WA",2014,961,894,67,7.000000
CN5302500000000,53,025,"Grant County, WA",2014,44677,41228,3449,7.700000
CN5302700000000,53,027,"Grays Harbor County, WA",2014,27447,24568,2879,10.500000
CN5302900000000,53,029,"Island County, WA",2014,31691,29498,2193,6.900000
CN5303100000000,53,031,"Jefferson County, WA",2014,11173,10242,931,8.300000
CN5303300000000,53,033,"King County, WA",2014,1158219,1104926,53293,4.600000
CN5303500000000,53,035,"Kitsap County, WA",2014,113222,106012,7210,6.400000
CN5303700000000,53,037,"Kittitas County, WA",2014,20013,18577,1436,7.200000
CN5303900000000,53,039,"Klickitat County, WA",2014,9684,8911,773,8.000000
CN5304100000000,53,041,"Lewis County, WA",2014,31035,28146,2889,9.300000
CN5304300000000,53,043,"Lincoln County, WA",2014,5051,4742,309,6.100000
CN5304500000000,53,045,"Mason County, WA",2014,23310,21302,2008,8.600000
CN5304700000000,53,047,"Okanogan County, WA",2014,21274,19685,1589,7.500000
CN5304900000000,53,049,"Pacific County, WA",2014,8048,7239,809,10.100000
CN5305100000000,53,051,"Pend Oreille County, WA",2014,4621,4147,474,10.300000
CN5305300000000,53,053,"Pierce County, WA",2014,384159,356190,27969,7.300000
CN5305500000000,53,055,"San Juan County, WA",2014,7657,7258,399,5.200000
CN5305700000000,53,057,"Skagit County, WA",2014,56640,52426,4214,7.400000
CN5305900000000,53,059,"Skamania County, WA",2014,4974,4548,426,8.600000
CN5306100000000,53,061,"Snohomish County, WA",2014,395317,374985,20332,5.100000
CN5306300000000,53,063,"Spokane County, WA",2014,225116,208925,16191,7.200000
CN5306500000000,53,065,"Stevens County, WA",2014,17584,15901,1683,9.600000
CN5306700000000,53,067,"Thurston County, WA",2014,123176,114921,8255,6.700000
CN5306900000000,53,069,"Wahkiakum County, WA",2014,1353,1224,129,9.500000
CN5307100000000,53,071,"Walla Walla County, WA",2014,28268,26450,1818,6.400000
CN5307300000000,53,073,"Whatcom County, WA",2014,101927,95092,6835,6.700000
CN5307500000000,53,075,"Whitman County, WA",2014,22060,20843,1217,5.500000
CN5307700000000,53,077,"Yakima County, WA",2014,119411,108656,10755,9.000000
CN5400100000000,54,001,"Barbour County, WV",2014,6667,6219,448,6.700000
CN5400300000000,54,003,"Berkeley County, WV",2014,52117,49369,2748,5.300000
CN5400500000000,54,005,"Boone County, WV",2014,8495,7733,762,9.000000
CN5400700000000,54,007,"Braxton County, WV",2014,5286,4801,485,9.200000
CN5400900000000,54,009,"Brooke County, WV",2014,10234,9493,741,7.200000
CN5401100000000,54,011,"Cabell County, WV",2014,42096,39791,2305,5.500000
CN5401300000000,54,013,"Calhoun County, WV",2014,2954,2674,280,9.500000
CN5401500000000,54,015,"Clay County, WV",2014,3389,3029,360,10.600000
CN5401700000000,54,017,"Doddridge County, WV",2014,3684,3503,181,4.900000
CN5401900000000,54,019,"Fayette County, WV",2014,16654,15275,1379,8.300000
CN5402100000000,54,021,"Gilmer County, WV",2014,2759,2584,175,6.300000
CN5402300000000,54,023,"Grant County, WV",2014,5860,5420,440,7.500000
CN5402500000000,54,025,"Greenbrier County, WV",2014,15254,14214,1040,6.800000
CN5402700000000,54,027,"Hampshire County, WV",2014,9556,8983,573,6.000000
CN5402900000000,54,029,"Hancock County, WV",2014,13246,12200,1046,7.900000
CN5403100000000,54,031,"Hardy County, WV",2014,5360,4938,422,7.900000
CN5403300000000,54,033,"Harrison County, WV",2014,32016,30314,1702,5.300000
CN5403500000000,54,035,"Jackson County, WV",2014,11917,11125,792,6.600000
CN5403700000000,54,037,"Jefferson County, WV",2014,27042,25834,1208,4.500000
CN5403900000000,54,039,"Kanawha County, WV",2014,88299,83110,5189,5.900000
CN5404100000000,54,041,"Lewis County, WV",2014,7249,6798,451,6.200000
CN5404300000000,54,043,"Lincoln County, WV",2014,7501,6794,707,9.400000
CN5404500000000,54,045,"Logan County, WV",2014,11959,10728,1231,10.300000
CN5404700000000,54,047,"McDowell County, WV",2014,5825,5071,754,12.900000
CN5404900000000,54,049,"Marion County, WV",2014,26487,24917,1570,5.900000
CN5405100000000,54,051,"Marshall County, WV",2014,14287,13203,1084,7.600000
CN5405300000000,54,053,"Mason County, WV",2014,10213,9257,956,9.400000
CN5405500000000,54,055,"Mercer County, WV",2014,22418,20746,1672,7.500000
CN5405700000000,54,057,"Mineral County, WV",2014,11792,10942,850,7.200000
CN5405900000000,54,059,"Mingo County, WV",2014,7823,6901,922,11.800000
CN5406100000000,54,061,"Monongalia County, WV",2014,50074,47880,2194,4.400000
CN5406300000000,54,063,"Monroe County, WV",2014,5618,5295,323,5.700000
CN5406500000000,54,065,"Morgan County, WV",2014,7411,6989,422,5.700000
CN5406700000000,54,067,"Nicholas County, WV",2014,10139,9231,908,9.000000
CN5406900000000,54,069,"Ohio County, WV",2014,21206,20035,1171,5.500000
CN5407100000000,54,071,"Pendleton County, WV",2014,3511,3345,166,4.700000
CN5407300000000,54,073,"Pleasants County, WV",2014,2988,2778,210,7.000000
CN5407500000000,54,075,"Pocahontas County, WV",2014,3570,3264,306,8.600000
CN5407700000000,54,077,"Preston County, WV",2014,14576,13732,844,5.800000
CN5407900000000,54,079,"Putnam County, WV",2014,25811,24386,1425,5.500000
CN5408100000000,54,081,"Raleigh County, WV",2014,31201,28997,2204,7.100000
CN5408300000000,54,083,"Randolph County, WV",2014,11849,11011,838,7.100000
CN5408500000000,54,085,"Ritchie County, WV",2014,4642,4360,282,6.100000
CN5408700000000,54,087,"Roane County, WV",2014,5329,4804,525,9.900000
CN5408900000000,54,089,"Summers County, WV",2014,4513,4195,318,7.000000
CN5409100000000,54,091,"Taylor County, WV",2014,7792,7382,410,5.300000
CN5409300000000,54,093,"Tucker County, WV",2014,3379,3162,217,6.400000
CN5409500000000,54,095,"Tyler County, WV",2014,3594,3273,321,8.900000
CN5409700000000,54,097,"Upshur County, WV",2014,9482,8852,630,6.600000
CN5409900000000,54,099,"Wayne County, WV",2014,15946,14868,1078,6.800000
CN5410100000000,54,101,"Webster County, WV",2014,3445,3149,296,8.600000
CN5410300000000,54,103,"Wetzel County, WV",2014,7282,6533,749,10.300000
CN5410500000000,54,105,"Wirt County, WV",2014,2282,2066,216,9.500000
CN5410700000000,54,107,"Wood County, WV",2014,37941,35711,2230,5.900000
CN5410900000000,54,109,"Wyoming County, WV",2014,8024,7269,755,9.400000
CN5500100000000,55,001,"Adams County, WI",2014,8610,7855,755,8.800000
CN5500300000000,55,003,"Ashland County, WI",2014,8075,7462,613,7.600000
CN5500500000000,55,005,"Barron County, WI",2014,23457,22033,1424,6.100000
CN5500700000000,55,007,"Bayfield County, WI",2014,7678,6946,732,9.500000
CN5500900000000,55,009,"Brown County, WI",2014,138840,131998,6842,4.900000
CN5501100000000,55,011,"Buffalo County, WI",2014,6538,6166,372,5.700000
CN5501300000000,55,013,"Burnett County, WI",2014,7511,6911,600,8.000000
CN5501500000000,55,015,"Calumet County, WI",2014,27452,26285,1167,4.300000
CN5501700000000,55,017,"Chippewa County, WI",2014,33126,31307,1819,5.500000
CN5501900000000,55,019,"Clark County, WI",2014,16984,16042,942,5.500000
CN5502100000000,55,021,"Columbia County, WI",2014,31594,29928,1666,5.300000
CN5502300000000,55,023,"Crawford County, WI",2014,8082,7513,569,7.000000
CN5502500000000,55,025,"Dane County, WI",2014,305878,294394,11484,3.800000
CN5502700000000,55,027,"Dodge County, WI",2014,47254,44608,2646,5.600000
CN5502900000000,55,029,"Door County, WI",2014,15556,14283,1273,8.200000
CN5503100000000,55,031,"Douglas County, WI",2014,23672,22311,1361,5.700000
CN5503300000000,55,033,"Dunn County, WI",2014,23614,22360,1254,5.300000
CN5503500000000,55,035,"Eau Claire County, WI",2014,58324,55653,2671,4.600000
CN5503700000000,55,037,"Florence County, WI",2014,2226,2060,166,7.500000
CN5503900000000,55,039,"Fond du Lac County, WI",2014,57371,54480,2891,5.000000
CN5504100000000,55,041,"Forest County, WI",2014,4009,3658,351,8.800000
CN5504300000000,55,043,"Grant County, WI",2014,27616,26290,1326,4.800000
CN5504500000000,55,045,"Green County, WI",2014,21112,20148,964,4.600000
CN5504700000000,55,047,"Green Lake County, WI",2014,10150,9486,664,6.500000
CN5504900000000,55,049,"Iowa County, WI",2014,13675,12966,709,5.200000
CN5505100000000,55,051,"Iron County, WI",2014,2726,2463,263,9.600000
CN5505300000000,55,053,"Jackson County, WI",2014,10116,9499,617,6.100000
CN5505500000000,55,055,"Jefferson County, WI",2014,45981,43596,2385,5.200000
CN5505700000000,55,057,"Juneau County, WI",2014,13373,12478,895,6.700000
CN5505900000000,55,059,"Kenosha County, WI",2014,87594,82225,5369,6.100000
CN5506100000000,55,061,"Kewaunee County, WI",2014,10983,10423,560,5.100000
CN5506300000000,55,063,"La Crosse County, WI",2014,66659,63726,2933,4.400000
CN5506500000000,55,065,"Lafayette County, WI",2014,9368,8962,406,4.300000
CN5506700000000,55,067,"Langlade County, WI",2014,9722,8989,733,7.500000
CN5506900000000,55,069,"Lincoln County, WI",2014,15075,14097,978,6.500000
CN5507100000000,55,071,"Manitowoc County, WI",2014,42493,39851,2642,6.200000
CN5507300000000,55,073,"Marathon County, WI",2014,73096,69334,3762,5.100000
CN5507500000000,55,075,"Marinette County, WI",2014,21371,19906,1465,6.900000
CN5507700000000,55,077,"Marquette County, WI",2014,7513,6975,538,7.200000
CN5507800000000,55,078,"Menominee County, WI",2014,1540,1338,202,13.100000
CN5507900000000,55,079,"Milwaukee County, WI",2014,480920,447273,33647,7.000000
CN5508100000000,55,081,"Monroe County, WI",2014,22584,21349,1235,5.500000
CN5508300000000,55,083,"Oconto County, WI",2014,20504,19223,1281,6.200000
CN5508500000000,55,085,"Oneida County, WI",2014,18418,17117,1301,7.100000
CN5508700000000,55,087,"Outagamie County, WI",2014,101302,96371,4931,4.900000
CN5508900000000,55,089,"Ozaukee County, WI",2014,47942,45870,2072,4.300000
CN5509100000000,55,091,"Pepin County, WI",2014,4042,3845,197,4.900000
CN5509300000000,55,093,"Pierce County, WI",2014,24371,23276,1095,4.500000
CN5509500000000,55,095,"Polk County, WI",2014,24296,22858,1438,5.900000
CN5509700000000,55,097,"Portage County, WI",2014,38892,36681,2211,5.700000
CN5509900000000,55,099,"Price County, WI",2014,6795,6427,368,5.400000
CN5510100000000,55,101,"Racine County, WI",2014,100103,93343,6760,6.800000
CN5510300000000,55,103,"Richland County, WI",2014,9325,8845,480,5.100000
CN5510500000000,55,105,"Rock County, WI",2014,83165,77988,5177,6.200000
CN5510700000000,55,107,"Rusk County, WI",2014,6675,6203,472,7.100000
CN5510900000000,55,109,"St. Croix County, WI",2014,48527,46335,2192,4.500000
CN5511100000000,55,111,"Sauk County, WI",2014,35321,33535,1786,5.100000
CN5511300000000,55,113,"Sawyer County, WI",2014,8061,7340,721,8.900000
CN5511500000000,55,115,"Shawano County, WI",2014,21346,20056,1290,6.000000
CN5511700000000,55,117,"Sheboygan County, WI",2014,61603,58759,2844,4.600000
CN5511900000000,55,119,"Taylor County, WI",2014,10949,10358,591,5.400000
CN5512100000000,55,121,"Trempealeau County, WI",2014,16387,15615,772,4.700000
CN5512300000000,55,123,"Vernon County, WI",2014,15083,14337,746,4.900000
CN5512500000000,55,125,"Vilas County, WI",2014,10062,9195,867,8.600000
CN5512700000000,55,127,"Walworth County, WI",2014,56765,53547,3218,5.700000
CN5512900000000,55,129,"Washburn County, WI",2014,7966,7453,513,6.400000
CN5513100000000,55,131,"Washington County, WI",2014,75840,72324,3516,4.600000
CN5513300000000,55,133,"Waukesha County, WI",2014,220918,210923,9995,4.500000
CN5513500000000,55,135,"Waupaca County, WI",2014,27225,25639,1586,5.800000
CN5513700000000,55,137,"Waushara County, WI",2014,11745,10904,841,7.200000
CN5513900000000,55,139,"Winnebago County, WI",2014,91977,87097,4880,5.300000
CN5514100000000,55,141,"Wood County, WI",2014,38800,36444,2356,6.100000
CN5600100000000,56,001,"Albany County, WY",2014,20558,19825,733,3.600000
CN5600300000000,56,003,"Big Horn County, WY",2014,5646,5383,263,4.700000
CN5600500000000,56,005,"Campbell County, WY",2014,26328,25412,916,3.500000
CN5600700000000,56,007,"Carbon County, WY",2014,8426,8076,350,4.200000
CN5600900000000,56,009,"Converse County, WY",2014,8348,8083,265,3.200000
CN5601100000000,56,011,"Crook County, WY",2014,3714,3564,150,4.000000
CN5601300000000,56,013,"Fremont County, WY",2014,20620,19550,1070,5.200000
CN5601500000000,56,015,"Goshen County, WY",2014,7224,6954,270,3.700000
CN5601700000000,56,017,"Hot Springs County, WY",2014,2492,2384,108,4.300000
CN5601900000000,56,019,"Johnson County, WY",2014,4482,4272,210,4.700000
CN5602100000000,56,021,"Laramie County, WY",2014,48899,46706,2193,4.500000
CN5602300000000,56,023,"Lincoln County, WY",2014,8210,7769,441,5.400000
CN5602500000000,56,025,"Natrona County, WY",2014,43305,41486,1819,4.200000
CN5602700000000,56,027,"Niobrara County, WY",2014,1368,1320,48,3.500000
CN5602900000000,56,029,"Park County, WY",2014,15795,15056,739,4.700000
CN5603100000000,56,031,"Platte County, WY",2014,4782,4589,193,4.000000
CN5603300000000,56,033,"Sheridan County, WY",2014,15960,15194,766,4.800000
CN5603500000000,56,035,"Sublette County, WY",2014,4874,4656,218,4.500000
CN5603700000000,56,037,"Sweetwater County, WY",2014,23353,22381,972,4.200000
CN5603900000000,56,039,"Teton County, WY",2014,14387,13697,690,4.800000
CN5604100000000,56,041,"Uinta County, WY",2014,9891,9393,498,5.000000
CN5604300000000,56,043,"Washakie County, WY",2014,4300,4106,194,4.500000
CN5604500000000,56,045,"Weston County, WY",2014,3970,3834,136,3.400000
CN7200100000000,72,001,"Adjuntas Municipio, PR",2014,4491,3504,987,22.000000
CN7200300000000,72,003,"Aguada Municipio, PR",2014,12120,10046,2074,17.100000
CN7200500000000,72,005,"Aguadilla Municipio, PR",2014,15136,12665,2471,16.300000
CN7200700000000,72,007,"Aguas Buenas Municipio, PR",2014,6978,5837,1141,16.400000
CN7200900000000,72,009,"Aibonito Municipio, PR",2014,6906,5700,1206,17.500000
CN7201100000000,72,011,"Anasco Municipio, PR",2014,9027,7551,1476,16.400000
CN7201300000000,72,013,"Arecibo Municipio, PR",2014,24816,21005,3811,15.400000
CN7201500000000,72,015,"Arroyo Municipio, PR",2014,5349,4110,1239,23.200000
CN7201700000000,72,017,"Barceloneta Municipio, PR",2014,6128,4902,1226,20.000000
CN7201900000000,72,019,"Barranquitas Municipio, PR",2014,7577,6386,1191,15.700000
CN7202100000000,72,021,"Bayamon Municipio, PR",2014,68866,61808,7058,10.200000
CN7202300000000,72,023,"Cabo Rojo Municipio, PR",2014,14490,12018,2472,17.100000
CN7202500000000,72,025,"Caguas Municipio, PR",2014,49141,43374,5767,11.700000
CN7202700000000,72,027,"Camuy Municipio, PR",2014,9789,8346,1443,14.700000
CN7202900000000,72,029,"Canovanas Municipio, PR",2014,16203,14083,2120,13.100000
CN7203100000000,72,031,"Carolina Municipio, PR",2014,63990,57701,6289,9.800000
CN7203300000000,72,033,"Catano Municipio, PR",2014,8284,7274,1010,12.200000
CN7203500000000,72,035,"Cayey Municipio, PR",2014,16499,14422,2077,12.600000
CN7203700000000,72,037,"Ceiba Municipio, PR",2014,4077,3391,686,16.800000
CN7203900000000,72,039,"Ciales Municipio, PR",2014,4243,3268,975,23.000000
CN7204100000000,72,041,"Cidra Municipio, PR",2014,15907,14012,1895,11.900000
CN7204300000000,72,043,"Coamo Municipio, PR",2014,11018,8691,2327,21.100000
CN7204500000000,72,045,"Comerio Municipio, PR",2014,5343,4344,999,18.700000
CN7204700000000,72,047,"Corozal Municipio, PR",2014,9625,8177,1448,15.000000
CN7204900000000,72,049,"Culebra Municipio, PR",2014,786,732,54,6.900000
CN7205100000000,72,051,"Dorado Municipio, PR",2014,12691,11549,1142,9.000000
CN7205300000000,72,053,"Fajardo Municipio, PR",2014,12140,10024,2116,17.400000
CN7205400000000,72,054,"Florida Municipio, PR",2014,3547,2880,667,18.800000
CN7205500000000,72,055,"Guanica Municipio, PR",2014,4547,3418,1129,24.800000
CN7205700000000,72,057,"Guayama Municipio, PR",2014,12393,9869,2524,20.400000
CN7205900000000,72,059,"Guayanilla Municipio, PR",2014,5556,4356,1200,21.600000
CN7206100000000,72,061,"Guaynabo Municipio, PR",2014,37504,35078,2426,6.500000
CN7206300000000,72,063,"Gurabo Municipio, PR",2014,16978,15183,1795,10.600000
CN7206500000000,72,065,"Hatillo Municipio, PR",2014,13183,11062,2121,16.100000
CN7206700000000,72,067,"Hormigueros Municipio, PR",2014,5673,4845,828,14.600000
CN7206900000000,72,069,"Humacao Municipio, PR",2014,18125,15007,3118,17.200000
CN7207100000000,72,071,"Isabela Municipio, PR",2014,12547,10661,1886,15.000000
CN7207300000000,72,073,"Jayuya Municipio, PR",2014,4230,3486,744,17.600000
CN7207500000000,72,075,"Juana Diaz Municipio, PR",2014,15824,13241,2583,16.300000
CN7207700000000,72,077,"Juncos Municipio, PR",2014,12485,10565,1920,15.400000
CN7207900000000,72,079,"Lajas Municipio, PR",2014,5983,4568,1415,23.700000
CN7208100000000,72,081,"Lares Municipio, PR",2014,7732,5948,1784,23.100000
CN7208300000000,72,083,"Las Marias Municipio, PR",2014,2884,2145,739,25.600000
CN7208500000000,72,085,"Las Piedras Municipio, PR",2014,11426,9578,1848,16.200000
CN7208700000000,72,087,"Loiza Municipio, PR",2014,9065,7872,1193,13.200000
CN7208900000000,72,089,"Luquillo Municipio, PR",2014,6709,5426,1283,19.100000
CN7209100000000,72,091,"Manati Municipio, PR",2014,11939,10303,1636,13.700000
CN7209300000000,72,093,"Maricao Municipio, PR",2014,1981,1566,415,20.900000
CN7209500000000,72,095,"Maunabo Municipio, PR",2014,3164,2487,677,21.400000
CN7209700000000,72,097,"Mayaguez Municipio, PR",2014,24502,20342,4160,17.000000
CN7209900000000,72,099,"Moca Municipio, PR",2014,10886,8899,1987,18.300000
CN7210100000000,72,101,"Morovis Municipio, PR",2014,8471,6907,1564,18.500000
CN7210300000000,72,103,"Naguabo Municipio, PR",2014,8300,7036,1264,15.200000
CN7210500000000,72,105,"Naranjito Municipio, PR",2014,7534,6282,1252,16.600000
CN7210700000000,72,107,"Orocovis Municipio, PR",2014,5452,4417,1035,19.000000
CN7210900000000,72,109,"Patillas Municipio, PR",2014,4954,3774,1180,23.800000
CN7211100000000,72,111,"Penuelas Municipio, PR",2014,6576,5197,1379,21.000000
CN7211300000000,72,113,"Ponce Municipio, PR",2014,49467,41885,7582,15.300000
CN7211500000000,72,115,"Quebradillas Municipio, PR",2014,6226,5087,1139,18.300000
CN7211700000000,72,117,"Rincon Municipio, PR",2014,4726,3785,941,19.900000
CN7211900000000,72,119,"Rio Grande Municipio, PR",2014,17349,15297,2052,11.800000
CN7212100000000,72,121,"Sabana Grande Municipio, PR",2014,6583,5361,1222,18.600000
CN7212300000000,72,123,"Salinas Municipio, PR",2014,8388,6186,2202,26.300000
CN7212500000000,72,125,"San German Municipio, PR",2014,10686,8780,1906,17.800000
CN7212700000000,72,127,"San Juan Municipio, PR",2014,138559,127108,11451,8.300000
CN7212900000000,72,129,"San Lorenzo Municipio, PR",2014,12325,10409,1916,15.500000
CN7213100000000,72,131,"San Sebastian Municipio, PR",2014,11168,8609,2559,22.900000
CN7213300000000,72,133,"Santa Isabel Municipio, PR",2014,9959,7999,1960,19.700000
CN7213500000000,72,135,"Toa Alta Municipio, PR",2014,25943,23526,2417,9.300000
CN7213700000000,72,137,"Toa Baja Municipio, PR",2014,30661,27546,3115,10.200000
CN7213900000000,72,139,"Trujillo Alto Municipio, PR",2014,27579,25387,2192,7.900000
CN7214100000000,72,141,"Utuado Municipio, PR",2014,7159,5836,1323,18.500000
CN7214300000000,72,143,"Vega Alta Municipio, PR",2014,10003,8627,1376,13.800000
CN7214500000000,72,145,"Vega Baja Municipio, PR",2014,14349,12048,2301,16.000000
CN7214700000000,72,147,"Vieques Municipio, PR",2014,3198,2754,444,13.900000
CN7214900000000,72,149,"Villalba Municipio, PR",2014,7990,6258,1732,21.700000
CN7215100000000,72,151,"Yabucoa Municipio, PR",2014,9739,7632,2107,21.600000
CN7215300000000,72,153,"Yauco Municipio, PR",2014,11162,8788,2374,21.300000